Conjunctiva	LABEL=Tissue
Conjunctival Epithelium	LABEL=Tissue
Melanocyte	LABEL=Cell
Apoptosis	LABEL=AssociatedBiologicalProcess
Positive Regulation of Cell Differentiation	LABEL=AssociatedBiologicalProcess
Testis	LABEL=Tissue
Heart	LABEL=Tissue
Ion Transport Process	LABEL=AssociatedBiologicalProcess
Signal Transduction Inhibition	LABEL=AssociatedBiologicalProcess
Signal Transduction	LABEL=AssociatedBiologicalProcess
Positive Regulation of Apoptosis	LABEL=AssociatedBiologicalProcess
G2 to M Transition Process	LABEL=AssociatedBiologicalProcess
Cell Proliferation Regulatory Process	LABEL=AssociatedBiologicalProcess
Hematopoietic Tissue	LABEL=Tissue
Neuroendocrine Cell	LABEL=Cell
Cell-Cell Adhesion Process	LABEL=AssociatedBiologicalProcess
Chemotactic Process	LABEL=AssociatedBiologicalProcess
Cell Adhesion Inhibition	LABEL=AssociatedBiologicalProcess
Cell Defense Process	LABEL=AssociatedBiologicalProcess
Plasma Cell	LABEL=Cell
Neutrophil	LABEL=Cell
Thymocyte	LABEL=Cell
Mature T-Lymphocyte	LABEL=Cell
Cell Adhesion Process	LABEL=AssociatedBiologicalProcess
Antigen Presenting Cell	LABEL=Cell
Leukocyte	LABEL=Cell
Next Generation Sequencing	LABEL=ResearchTechnique
Large-Scale Sequencing	LABEL=ResearchTechnique
Whole Genome Sequencing	LABEL=ResearchTechnique
Whole Exome Sequencing	LABEL=ResearchTechnique
Cell Growth Regulation	LABEL=AssociatedBiologicalProcess
Meiosis	LABEL=AssociatedBiologicalProcess
Mitotic Sister Chromatid Cohesion	LABEL=AssociatedBiologicalProcess
Prometaphase	LABEL=AssociatedBiologicalProcess
B-Cell Differentiation	LABEL=AssociatedBiologicalProcess
Negative Regulation of Apoptosis	LABEL=AssociatedBiologicalProcess
Cellular Migration Process	LABEL=AssociatedBiologicalProcess
Endothelial Cell	LABEL=Cell
Cell Differentiation Process	LABEL=AssociatedBiologicalProcess
Microtubule Process	LABEL=AssociatedBiologicalProcess
Kidney	LABEL=Tissue
Muscle Tissue	LABEL=Tissue
Cell Motility	LABEL=AssociatedBiologicalProcess
Lymph Node Tissue	LABEL=Tissue
Tonsillar Tissue	LABEL=Tissue
Extracellular Matrix	LABEL=Tissue
Cell-Matrix Adhesion Process	LABEL=AssociatedBiologicalProcess
Cytoskeletal Modeling	LABEL=AssociatedBiologicalProcess
Brain	LABEL=Tissue
Epithelial Cell	LABEL=Cell
In Vitro Bioequivalence or Bioanalytical Testing	LABEL=ResearchTechnique
Research Technique	LABEL=ResearchTechnique
Inhibition of Cell Proliferation	LABEL=AssociatedBiologicalProcess
Signal Transduction Induction	LABEL=AssociatedBiologicalProcess
Regulation of Cell Death Process	LABEL=AssociatedBiologicalProcess
Cell Division Process	LABEL=AssociatedBiologicalProcess
Cell Cycle Regulation Process	LABEL=AssociatedBiologicalProcess
Cell Proliferation	LABEL=AssociatedBiologicalProcess
Regulation of Cell Shape	LABEL=AssociatedBiologicalProcess
Basophil	LABEL=Cell
Mast Cell	LABEL=Cell
Negative Regulation of Cell Cycle	LABEL=AssociatedBiologicalProcess
Leukocyte Trafficking Induction	LABEL=AssociatedBiologicalProcess
Positive Regulation of Mitosis	LABEL=AssociatedBiologicalProcess
Cell Surface Extension	LABEL=AssociatedBiologicalProcess
Regulation of Cell Size	LABEL=AssociatedBiologicalProcess
Cell Cycle Progression	LABEL=AssociatedBiologicalProcess
Keratinocyte Differentiation	LABEL=AssociatedBiologicalProcess
Beta Cell	LABEL=Cell
Natural Killer Cell	LABEL=Cell
CD8-Positive T-Lymphocyte	LABEL=Cell
Gamma/Delta T-Lymphocyte	LABEL=Cell
Small Intestinal Goblet Cell	LABEL=Cell
Negative Regulation of Microtubule Depolymerization	LABEL=AssociatedBiologicalProcess
Cytokinesis	LABEL=AssociatedBiologicalProcess
Perihilar Lymph Node	LABEL=Tissue
Lymph Node by Anatomic Site	LABEL=Tissue
Epithelial-to-Mesenchymal Transition	LABEL=AssociatedBiologicalProcess
Pyramidal Cell	LABEL=Cell
Stimulation of Cell Proliferation	LABEL=AssociatedBiologicalProcess
Intestine	LABEL=Tissue
Hepatic Tissue	LABEL=Tissue
Renal Tissue	LABEL=Tissue
Outer Plexiform Layer	LABEL=Tissue
Cell Migration Induction	LABEL=AssociatedBiologicalProcess
Neuron	LABEL=Cell
Cell Movement	LABEL=AssociatedBiologicalProcess
Line Probe Assay	LABEL=ResearchTechnique
Molecular Genetic Technique	LABEL=ResearchTechnique
Loop-mediated Isothermal Amplification	LABEL=ResearchTechnique
Nucleic Acid Amplification Test	LABEL=ResearchTechnique
Microbial Liquid Culture	LABEL=ResearchTechnique
Culturing, In Vitro Microbial	LABEL=ResearchTechnique
Microbial Solid Culture	LABEL=ResearchTechnique
Superficial Lymph Node	LABEL=Tissue
Lymph Node	LABEL=Tissue
Chromosome Segregation	LABEL=AssociatedBiologicalProcess
B-Lymphocyte	LABEL=Cell
Monocyte	LABEL=Cell
Dendritic Cell	LABEL=Cell
Lymphoid Tissue	LABEL=Tissue
G1/S Transition Checkpoint	LABEL=AssociatedBiologicalProcess
Mitotic/Spindle Checkpoint	LABEL=AssociatedBiologicalProcess
Cell Migration Inhibition Process	LABEL=AssociatedBiologicalProcess
Cell Fate Control	LABEL=AssociatedBiologicalProcess
Mammary Gland	LABEL=Tissue
Ovary	LABEL=Tissue
Prostate Gland	LABEL=Tissue
Epithelial Tissue	LABEL=Tissue
Induction of Cell Senescence	LABEL=AssociatedBiologicalProcess
Cytotoxic T-Lymphocyte	LABEL=Cell
Photoacoustic Spectroscopy	LABEL=ResearchTechnique
Spectroscopy	LABEL=ResearchTechnique
Common Iliac Lymph Node	LABEL=Tissue
Iliac Lymph Node	LABEL=Tissue
Median Or Lower Cervical Lymph Node	LABEL=Tissue
Paratracheal Lymph Node	LABEL=Tissue
Posterior Cervical Lymph Node	LABEL=Tissue
Cervical Lymph Node	LABEL=Tissue
Preauricular Lymph Node	LABEL=Tissue
Retrocrural Lymph Node	LABEL=Tissue
Upper Cervical Lymph Node	LABEL=Tissue
Occipital Scalp	LABEL=Tissue
Scalp	LABEL=Tissue
High Performance Liquid Chromatography Mass Spectrometry	LABEL=ResearchTechnique
High Performance Liquid Chromatography	LABEL=ResearchTechnique
Liquid Chromatography Mass Spectrometry	LABEL=ResearchTechnique
Negative Regulation of Cell-Matrix Adhesion	LABEL=AssociatedBiologicalProcess
Positive Regulation of Cell Death	LABEL=AssociatedBiologicalProcess
Lung Tissue	LABEL=Tissue
Macrophage	LABEL=Cell
Cell Survival	LABEL=AssociatedBiologicalProcess
Platelet	LABEL=Cell
Eosinophil	LABEL=Cell
Langerhans Cell	LABEL=Cell
Activated Lymphocyte	LABEL=Cell
T-Cell Proliferation	LABEL=AssociatedBiologicalProcess
Naive T-Lymphocyte	LABEL=Cell
Memory T-Lymphocyte	LABEL=Cell
Effector T-Lymphocyte	LABEL=Cell
Cell Death Process	LABEL=AssociatedBiologicalProcess
Gastric Tissue	LABEL=Tissue
T-Lymphocyte	LABEL=Cell
Myocardium	LABEL=Tissue
Positive Regulation of Cytolytic Process	LABEL=AssociatedBiologicalProcess
Type 1 Helper Cell	LABEL=Cell
Microtubule Depolymerization Process	LABEL=AssociatedBiologicalProcess
Germ Cell	LABEL=Cell
Negative Regulation of Cell Differentiation	LABEL=AssociatedBiologicalProcess
T-Cell Differentiation	LABEL=AssociatedBiologicalProcess
Activated Natural Killer Cell	LABEL=Cell
Nerve Tissue	LABEL=Tissue
Autophagy	LABEL=AssociatedBiologicalProcess
Mitosis	LABEL=AssociatedBiologicalProcess
Microtubule Polymerization Process	LABEL=AssociatedBiologicalProcess
Hematopoietic and Lymphoid Tissue	LABEL=Tissue
Spinal Cord	LABEL=Tissue
G1 Phase Process	LABEL=AssociatedBiologicalProcess
S Phase Process	LABEL=AssociatedBiologicalProcess
Negative Regulation of Cell Death	LABEL=AssociatedBiologicalProcess
Erythrocyte	LABEL=Cell
Intercalated Cell	LABEL=Cell
Cardiomyocyte	LABEL=Cell
Pancreas	LABEL=Tissue
Adrenal Gland	LABEL=Tissue
Stress Response Signaling	LABEL=AssociatedBiologicalProcess
Caspase Activation	LABEL=AssociatedBiologicalProcess
Caspase-Dependent Apoptosis	LABEL=AssociatedBiologicalProcess
Epidermis	LABEL=Tissue
Connective Tissue	LABEL=Tissue
Intestinal Wall Tissue	LABEL=Tissue
Keratinization Induction	LABEL=AssociatedBiologicalProcess
Keratinocyte	LABEL=Cell
Distant Lymph Node	LABEL=Tissue
Chromatin Immunoprecipitation	LABEL=ResearchTechnique
Molecular Analysis	LABEL=ResearchTechnique
ChIP-Seq	LABEL=ResearchTechnique
DNA Analysis	LABEL=ResearchTechnique
ChIP-On-Chip	LABEL=ResearchTechnique
FAIRE-Seq	LABEL=ResearchTechnique
DNase-Seq	LABEL=ResearchTechnique
NOMe-Seq	LABEL=ResearchTechnique
Bisulfite Sequencing	LABEL=ResearchTechnique
MethylC-Seq	LABEL=ResearchTechnique
MNase Sequencing	LABEL=ResearchTechnique
Cell Cycle Process	LABEL=AssociatedBiologicalProcess
Adipose Tissue	LABEL=Tissue
Skeletal Muscle Tissue	LABEL=Tissue
Cell Cycle Checkpoint	LABEL=AssociatedBiologicalProcess
Spermatid	LABEL=Cell
Eye	LABEL=Tissue
Cytoskeletal Process	LABEL=AssociatedBiologicalProcess
Podocyte	LABEL=Cell
Testicular Tissue	LABEL=Tissue
Flame Photometry	LABEL=ResearchTechnique
Photometry	LABEL=ResearchTechnique
Immunoturbidimetry	LABEL=ResearchTechnique
Basement Membrane	LABEL=Tissue
Intraepithelial T-Lymphocyte	LABEL=Cell
Pancreatic Stellate Cell	LABEL=Cell
Connective and Soft Tissue Cell	LABEL=Cell
Exocrine Pancreas	LABEL=Tissue
Intestinal Epithelium	LABEL=Tissue
Osteoclast	LABEL=Cell
Tumor Infiltrating Macrophages	LABEL=Cell
Electrochemiluminescence	LABEL=ResearchTechnique
Gas Chromatography Mass Spectrometry	LABEL=ResearchTechnique
Mass Spectrometry	LABEL=ResearchTechnique
Nephelometry	LABEL=ResearchTechnique
Refractometry	LABEL=ResearchTechnique
Turbidimetry	LABEL=ResearchTechnique
Negative Regulation of Mitosis	LABEL=AssociatedBiologicalProcess
Spermatogenic Cell	LABEL=Cell
Metastasis Suppression	LABEL=AssociatedBiologicalProcess
Recent Thymic Emigrant	LABEL=Cell
Peripheral (Post-Thymic) T-Lymphocyte	LABEL=Cell
Peripheral Blood Lymphocyte	LABEL=Cell
Flow Microscopy	LABEL=ResearchTechnique
Brown Adipose Tissue	LABEL=Tissue
Lymphocyte	LABEL=Cell
Oligodendrocyte	LABEL=Cell
Particle Sizing	LABEL=ResearchTechnique
Physical Chemical Technique	LABEL=ResearchTechnique
Cell Bank Characterization	LABEL=ResearchTechnique
Cell Culture	LABEL=ResearchTechnique
Cell Bank Maintenance	LABEL=ResearchTechnique
Cell Culture Pooling	LABEL=ResearchTechnique
Disposable Bag Culture	LABEL=ResearchTechnique
Flask or Bottle Culture	LABEL=ResearchTechnique
Perfusion Culture	LABEL=ResearchTechnique
Scaffold Seeding	LABEL=ResearchTechnique
Air Classification Particle Sizing	LABEL=ResearchTechnique
Cooling/Congealing Particle Sizing	LABEL=ResearchTechnique
Particle Sizing, Not Otherwise Specified	LABEL=ResearchTechnique
Screening Particle Sizing	LABEL=ResearchTechnique
Size Reduction Particle Sizing	LABEL=ResearchTechnique
Wet Milling Particle Sizing	LABEL=ResearchTechnique
Cell Aging	LABEL=AssociatedBiologicalProcess
Chemotaxis Induction	LABEL=AssociatedBiologicalProcess
Adrenal Medulla	LABEL=Tissue
Regulatory B Cell	LABEL=Cell
Mature B-Lymphocyte	LABEL=Cell
Immature Myeloid Cell	LABEL=Cell
Myeloid Cell	LABEL=Cell
Mammary Gland Tissue	LABEL=Tissue
Splenic Tissue	LABEL=Tissue
Pancreatic Duct	LABEL=Tissue
Branch Duct	LABEL=Tissue
Duct	LABEL=Tissue
Inferior Mediastinal Lymph Node	LABEL=Tissue
Mediastinal Lymph Node	LABEL=Tissue
T Helper 17 Cell	LABEL=Cell
Helper-Inducer T-Lymphocyte	LABEL=Cell
Bone Matrix	LABEL=Tissue
Vascular Endothelium	LABEL=Tissue
SCID-Repopulating Cell	LABEL=Cell
Hematopoietic Stem Cell	LABEL=Cell
Cell Mobility	LABEL=AssociatedBiologicalProcess
Prophase Process	LABEL=AssociatedBiologicalProcess
Tectorial Membrane	LABEL=Tissue
Breast Fibroglandular Tissue	LABEL=Tissue
Fibroblast	LABEL=Cell
Pyroptosis	LABEL=AssociatedBiologicalProcess
Stem Cell Differentiation	LABEL=AssociatedBiologicalProcess
CXCL12-Abundant Reticular Cell	LABEL=Cell
Reticular Cell	LABEL=Cell
Pituitary Gland	LABEL=Tissue
Gonad	LABEL=Tissue
Mucosa	LABEL=Tissue
Soft Tissue	LABEL=Tissue
Glial Cell	LABEL=Cell
Circulating Stem Cell	LABEL=Cell
Stem Cell	LABEL=Cell
Epithelium	LABEL=Tissue
Invariant Natural Killer T-Cell	LABEL=Cell
Mucosal-Associated Invariant T-Cell	LABEL=Cell
Bladder	LABEL=Tissue
Urethra	LABEL=Tissue
Circulating Adipose Stromal Cell	LABEL=Cell
Lipocyte	LABEL=Cell
Cross-linking Immunoprecipitation High-throughput Sequencing	LABEL=ResearchTechnique
Direct Sequencing	LABEL=ResearchTechnique
Biopolymer Sequencing	LABEL=ResearchTechnique
Digital Array	LABEL=ResearchTechnique
Polymerase Chain Reaction	LABEL=ResearchTechnique
Multiple Complete Digest Restriction Fragment Mapping	LABEL=ResearchTechnique
Restriction Enzyme Mapping	LABEL=ResearchTechnique
Multiplex Ligation-dependent Probe Amplification	LABEL=ResearchTechnique
Optical Mapping	LABEL=ResearchTechnique
Skin Of The Axilla	LABEL=Tissue
Skin	LABEL=Tissue
Skin of the Upper Limb and Shoulder	LABEL=Tissue
Aortopulmonary Window Lymph Node	LABEL=Tissue
Oncotype DX DCIS Score	LABEL=ResearchTechnique
Tumor-Associated Macrophage	LABEL=Cell
Bone Marrow-Derived Cell	LABEL=Cell
Hematopoietic and Lymphoid Cell	LABEL=Cell
Retinal Pigment Epithelium	LABEL=Tissue
Fiber-Optic Spectroscopy	LABEL=ResearchTechnique
Polarized Reflectance Spectroscopy	LABEL=ResearchTechnique
Allele-Specific Oligonucleotide Real-Time Quantitative Polymerase Chain Reaction	LABEL=ResearchTechnique
Real Time PCR	LABEL=ResearchTechnique
Cell Proliferation Assay	LABEL=ResearchTechnique
Cellular Assay	LABEL=ResearchTechnique
Circulating Tumor Cell Analysis	LABEL=ResearchTechnique
Fourier Transform Ion Cyclotron Resonance Mass Spectrometry	LABEL=ResearchTechnique
Immunologic Technique	LABEL=ResearchTechnique
Magnetic Affinity Cell Sorting	LABEL=ResearchTechnique
Cell Sorting	LABEL=ResearchTechnique
Spectrophotometry	LABEL=ResearchTechnique
Platelet Aggregation Process	LABEL=AssociatedBiologicalProcess
HBV Genotype Assay	LABEL=ResearchTechnique
Genotyping	LABEL=ResearchTechnique
HCV Genotype Assay	LABEL=ResearchTechnique
Paracaval Lymph Node	LABEL=Tissue
Pericardial Lymph Node	LABEL=Tissue
Porta Hepatis Lymph Node	LABEL=Tissue
Portacaval Lymph Node	LABEL=Tissue
Subcarinal Lymph Node	LABEL=Tissue
Tracheobronchial Tree	LABEL=Tissue
Organ	LABEL=Tissue
Cell Death Signaling Process	LABEL=AssociatedBiologicalProcess
Nuclear Division	LABEL=AssociatedBiologicalProcess
Smooth Muscle Cell	LABEL=Cell
Germline Genotype Testing	LABEL=ResearchTechnique
Blood Vessel Endothelium	LABEL=Tissue
Gastrohepatic Lymph Node	LABEL=Tissue
Aortocaval Lymph Node	LABEL=Tissue
B Cell Proliferation	LABEL=AssociatedBiologicalProcess
Regulation of Antibody Titer Process	LABEL=AssociatedBiologicalProcess
Mitotic Chromosomal Process	LABEL=AssociatedBiologicalProcess
Ventricular Wall of the Heart	LABEL=Tissue
Cardiac Tissue	LABEL=Tissue
Right Eye	LABEL=Tissue
Left Eye	LABEL=Tissue
Both Eyes	LABEL=Tissue
Nerve Cell Survival	LABEL=AssociatedBiologicalProcess
Exhausted T-Cell	LABEL=Cell
Spleen	LABEL=Tissue
Negative Regulation of G1 Phase	LABEL=AssociatedBiologicalProcess
Negative Regulation of G2 to M Transition	LABEL=AssociatedBiologicalProcess
SPF10-LiPA PCR Assay	LABEL=ResearchTechnique
GP5+/GP6+ PCR Assay	LABEL=ResearchTechnique
PGMY09/PGMY11 PCR Assay	LABEL=ResearchTechnique
MY09/MY11 PCR Assay	LABEL=ResearchTechnique
Linear Array HPV Genotyping Test	LABEL=ResearchTechnique
Glabrous Skin	LABEL=Tissue
Non-Glabrous Skin	LABEL=Tissue
Pectoral Lymph Node	LABEL=Tissue
Axillary Lymph Node	LABEL=Tissue
Fibrocyte	LABEL=Cell
Islet of Langerhans	LABEL=Tissue
Uterus	LABEL=Tissue
Trachea	LABEL=Tissue
Bone Marrow	LABEL=Tissue
T-Lymphocyte and Natural Killer Cell	LABEL=Cell
Analytical Ultracentrifugation	LABEL=ResearchTechnique
Centrifugation	LABEL=ResearchTechnique
Gas Chromatography/Tandem Mass Spectrometry	LABEL=ResearchTechnique
Gas Chromatography	LABEL=ResearchTechnique
Gas Chromatography/Chemical Ionization Mass Spectrometry	LABEL=ResearchTechnique
Gas Chromatography/Electron Ionization Mass Spectrometry	LABEL=ResearchTechnique
High-performance Liquid Chromatography/Ion-Exchange Chromatography	LABEL=ResearchTechnique
High-performance Liquid Chromatography/Tandem Mass Spectrometry	LABEL=ResearchTechnique
High-performance Liquid Chromatography-Fluorescence	LABEL=ResearchTechnique
High-performance Liquid Chromatography-UV	LABEL=ResearchTechnique
Neuronophagia	LABEL=AssociatedBiologicalProcess
Phagocytosis	LABEL=AssociatedBiologicalProcess
Thymic Tissue	LABEL=Tissue
FSH Cell	LABEL=Cell
LH Cell	LABEL=Cell
Subcutis	LABEL=Tissue
Breast	LABEL=Tissue
Cardiophrenic Lymph Node	LABEL=Tissue
Dermis	LABEL=Tissue
Negative Regulation of Microtubule Polymerization	LABEL=AssociatedBiologicalProcess
Medullary Bone	LABEL=Tissue
Incision-induced Bleeding Method	LABEL=ResearchTechnique
Negative Regulation of G2 Phase	LABEL=AssociatedBiologicalProcess
Cryoscopy	LABEL=ResearchTechnique
Duke Incision Method	LABEL=ResearchTechnique
Enzymatic Ultracentrifugation	LABEL=ResearchTechnique
Ivy Incision Method	LABEL=ResearchTechnique
Liquid Chromatography/Tandem Mass Spectrometry	LABEL=ResearchTechnique
Liquid Chromatography-Fluorescence	LABEL=ResearchTechnique
Liquid Chromatography	LABEL=ResearchTechnique
Liquid Scintillation Counting	LABEL=ResearchTechnique
Template Incision Method	LABEL=ResearchTechnique
Transcription-mediated Amplification	LABEL=ResearchTechnique
Ultra High-performance Liquid Chromatography/Tandem Mass Spectrometry	LABEL=ResearchTechnique
Mucosa of the Upper Lip	LABEL=Tissue
Mucosa of the Lip	LABEL=Tissue
Mucosa of the Lower Lip	LABEL=Tissue
Oral Mucosa	LABEL=Tissue
Tongue	LABEL=Tissue
Submandibular Gland	LABEL=Tissue
Major Salivary Gland	LABEL=Tissue
Sublingual Salivary Gland	LABEL=Tissue
Tonsil	LABEL=Tissue
Esophagus	LABEL=Tissue
Stomach	LABEL=Tissue
Central Memory Immune Cell	LABEL=Cell
Immune Cell	LABEL=Cell
Effector Memory Immune Cell	LABEL=Cell
Effector Immune Cell	LABEL=Cell
Suppressive Monocyte	LABEL=Cell
Ear	LABEL=Tissue
Skin of the Lip	LABEL=Tissue
Skin of the Face	LABEL=Tissue
Skin of the Scalp and Neck	LABEL=Tissue
Skin of the Trunk	LABEL=Tissue
Skin of the Lower Limb and Hip	LABEL=Tissue
Vulva	LABEL=Tissue
Endometrium	LABEL=Tissue
Myometrium	LABEL=Tissue
Smooth Muscle Tissue	LABEL=Tissue
Parametrium	LABEL=Tissue
Tissue	LABEL=Tissue
Prepuce	LABEL=Tissue
Penis	LABEL=Tissue
Epididymis	LABEL=Tissue
Spermatic Cord	LABEL=Tissue
Urethral Gland	LABEL=Tissue
Exocrine Gland	LABEL=Tissue
Choroid	LABEL=Tissue
Membrane	LABEL=Tissue
Lacrimal Gland	LABEL=Tissue
Axillary Lymph Node Level I	LABEL=Tissue
Axillary Lymph Node Level II	LABEL=Tissue
Axillary Lymph Node Level III	LABEL=Tissue
Meninges	LABEL=Tissue
Membrane of the Brain or Spinal Cord	LABEL=Tissue
Cerebral Meninges	LABEL=Tissue
Spinal Meninges	LABEL=Tissue
Head and Neck Lymph Node	LABEL=Tissue
Intrathoracic Lymph Node	LABEL=Tissue
Thoracic Lymph Node	LABEL=Tissue
Intra-Abdominal Lymph Node	LABEL=Tissue
Lymph Node of Inguinal Region or Leg	LABEL=Tissue
Pelvic Lymph Node	LABEL=Tissue
Striated Muscle Tissue	LABEL=Tissue
Gitter Cell	LABEL=Cell
Microglia	LABEL=Cell
Connective and Soft Tissue	LABEL=Tissue
Bile Duct	LABEL=Tissue
Biliary Tract	LABEL=Tissue
Gallbladder	LABEL=Tissue
Conventional Dendritic Cell	LABEL=Cell
M2 Macrophage	LABEL=Cell
Cell Response Index	LABEL=ResearchTechnique
Genome-Wide 5-Hydroxymethylcytosine Profile	LABEL=ResearchTechnique
DNA Methylation Analysis	LABEL=ResearchTechnique
Cytokine and Angiogenic Factor Profile	LABEL=ResearchTechnique
Differential Methylation	LABEL=ResearchTechnique
Growth Behavior	LABEL=AssociatedBiologicalProcess
Cell Growth	LABEL=AssociatedBiologicalProcess
Liver	LABEL=Tissue
Organ of Special Sense	LABEL=Tissue
Adrenal Cortex	LABEL=Tissue
Adrenal Gland Tissue	LABEL=Tissue
Glandular Epithelial Tissue	LABEL=Tissue
Neuroendocrine Tissue	LABEL=Tissue
Pineal Gland	LABEL=Tissue
Endocrine Gland	LABEL=Tissue
Thyroid Gland	LABEL=Tissue
Fallopian Tube	LABEL=Tissue
Pregnant Uterus	LABEL=Tissue
Vagina	LABEL=Tissue
Epithelial Cell Proliferation	LABEL=AssociatedBiologicalProcess
Scrotum	LABEL=Tissue
Cardiac Stem Cell	LABEL=Cell
Multipotent Stem Cell	LABEL=Cell
Induced Pluripotent Stem Cell	LABEL=Cell
Pluripotent Stem Cell	LABEL=Cell
Endothelial Progenitor Cell	LABEL=Cell
Human Umbilical Cord Perivascular Cell	LABEL=Cell
Mesenchymal Stem Cell	LABEL=Cell
Ureter	LABEL=Tissue
Salivary Gland	LABEL=Tissue
Whole Transcriptome Sequencing	LABEL=ResearchTechnique
Parotid Gland	LABEL=Tissue
Serous Salivary Gland	LABEL=Tissue
Thymus Gland	LABEL=Tissue
Corpus Callosum	LABEL=Tissue
Cerebral White Matter	LABEL=Tissue
Substantia Nigra	LABEL=Tissue
Brain Gray Matter	LABEL=Tissue
Lung	LABEL=Tissue
Pleura	LABEL=Tissue
Synovial Membrane	LABEL=Tissue
Joint Capsule	LABEL=Tissue
Basal Cell	LABEL=Cell
Cell of the Epidermis	LABEL=Cell
Astrocyte	LABEL=Cell
Clear Cell	LABEL=Cell
Glandular Cell	LABEL=Cell
Ductal Epithelial Cell	LABEL=Cell
Ductal Epithelium	LABEL=Tissue
Glandular Epithelium	LABEL=Tissue
Terminal Ductal Lobular Unit	LABEL=Tissue
Endothelium	LABEL=Tissue
Spermatogonium	LABEL=Cell
Endocrine Cell	LABEL=Cell
Tympanic Membrane	LABEL=Tissue
Buccal Mucosa	LABEL=Tissue
Cell	LABEL=Cell
Blastomere	LABEL=Cell
Totipotent Stem Cell	LABEL=Cell
Embryonic Cell	LABEL=Cell
Peripheral Blood Cell	LABEL=Cell
Erythroid Stem Cell	LABEL=Cell
Bone Marrow Myeloid Stem Cell	LABEL=Cell
Erythroblast	LABEL=Cell
Reticulocyte	LABEL=Cell
Granulocyte	LABEL=Cell
Peripheral (Post-Thymic) T-Lymphocyte and Natural Killer Cell	LABEL=Cell
CD4-Positive T-Lymphocyte	LABEL=Cell
Type 2 Helper Cell	LABEL=Cell
Suppressor-Inducer T-Lymphocyte	LABEL=Cell
Suppressor-Effector T-Lymphocyte	LABEL=Cell
Tumor Infiltrating Lymphocyte	LABEL=Cell
Bone Marrow Blood-Forming Cell	LABEL=Cell
Bone Marrow Stem Cell	LABEL=Cell
Megakaryocyte	LABEL=Cell
Embryonic Stem Cell	LABEL=Cell
Chromaffin Cell	LABEL=Cell
Neural Crest-Derived Cell	LABEL=Cell
Adipocyte	LABEL=Cell
Chondrocyte	LABEL=Cell
Cartilage Cell	LABEL=Cell
Hyaline Cartilage	LABEL=Tissue
Phagocytic Cell	LABEL=Cell
Epithelioid Cell	LABEL=Cell
Histiocyte	LABEL=Cell
Histiocytic and Dendritic Cell	LABEL=Cell
Kupffer Cell	LABEL=Cell
Hepatic Sinusoid	LABEL=Tissue
Alveolar Macrophage	LABEL=Cell
Peritoneal Macrophage	LABEL=Cell
Peritoneum	LABEL=Tissue
Odontoblast	LABEL=Cell
Tooth Cell	LABEL=Cell
Osteoblast	LABEL=Cell
Bone Cell	LABEL=Cell
Osteocyte	LABEL=Cell
Stromal Cell	LABEL=Cell
Theca Cell	LABEL=Cell
Endocrine-Stromal Cell	LABEL=Cell
Endocrine Cell of the Digestive System	LABEL=Cell
Delta Cell	LABEL=Cell
Enterochromaffin Cell	LABEL=Cell
Enterochromaffin-Like Cell	LABEL=Cell
G-Cell	LABEL=Cell
Ameloblast	LABEL=Cell
Chief Cell	LABEL=Cell
Specialized Epithelial Cell	LABEL=Cell
Enterocyte	LABEL=Cell
Gut Epithelium	LABEL=Tissue
Goblet Cell	LABEL=Cell
Secretory Cell	LABEL=Cell
Granulosa Cell	LABEL=Cell
Hepatocyte	LABEL=Cell
Skin Squamous Cell	LABEL=Cell
Ion Semiconductor Sequencing	LABEL=ResearchTechnique
Nucleic Acid Sequencing	LABEL=ResearchTechnique
Anal Sac	LABEL=Tissue
Supporting Cell of Organ of Corti	LABEL=Cell
Non-Cellular Component	LABEL=Tissue
Merkel Cell	LABEL=Cell
Paneth Cell	LABEL=Cell
Small Intestinal Mucosa	LABEL=Tissue
Parietal Cell	LABEL=Cell
Gastric Glandular Cell	LABEL=Cell
Cardia Gland	LABEL=Tissue
Fundic Gland	LABEL=Tissue
Sertoli Cell	LABEL=Cell
Seminiferous Tubule	LABEL=Tissue
Particle-Enhanced Nephelometric Immunoassay	LABEL=ResearchTechnique
Particle-Enhanced Turbidimetric Immunoassay	LABEL=ResearchTechnique
Eukaryotic Cell	LABEL=Cell
Oocyte	LABEL=Cell
Primary Oocyte	LABEL=Cell
Zygote	LABEL=Cell
Spermatozoon	LABEL=Cell
Spermatocyte	LABEL=Cell
Leydig Cell	LABEL=Cell
Endocrine Testis	LABEL=Tissue
Lutein Cell	LABEL=Cell
Endocrine Ovary	LABEL=Tissue
Gene Modification	LABEL=ResearchTechnique
Antibody-Producing Cell	LABEL=Cell
Muscle Cell	LABEL=Cell
Supporting Cell of the Nervous System	LABEL=Cell
Neuroepithelial Cell	LABEL=Cell
Neuropil	LABEL=Tissue
Gray Matter	LABEL=Tissue
Perineuronal Satellite Cell	LABEL=Cell
Satellite Cell	LABEL=Cell
Schwann Cell	LABEL=Cell
Perineural Cell	LABEL=Cell
Follicular Dendritic Cell	LABEL=Cell
Germinal Center	LABEL=Tissue
Neuron, Neuroepithelial Cell, and Supporting Cell of the Nervous System	LABEL=Cell
Interneuron	LABEL=Cell
Multipolar Neuron	LABEL=Cell
Amacrine Cell	LABEL=Cell
Sensory Neuron	LABEL=Cell
Hair Cell	LABEL=Cell
Mechanoreceptor Cell	LABEL=Cell
Type I Hair Cell	LABEL=Cell
Type II Hair Cell	LABEL=Cell
Vestibular Hair Cell	LABEL=Cell
Olfactory Receptor Neuron	LABEL=Cell
Photoreceptor Cell	LABEL=Cell
Retinal Ganglion Cell	LABEL=Cell
Neural Retina	LABEL=Tissue
Dehydration	LABEL=ResearchTechnique
Cone	LABEL=Cell
Rod	LABEL=Cell
Posterior Horn Cell	LABEL=Cell
Effector Memory T-Lymphocyte	LABEL=Cell
Ganglion Cell	LABEL=Cell
Ganglion Cell Layer	LABEL=Tissue
Central Memory T-Lymphocyte	LABEL=Cell
Efferent Neuron	LABEL=Cell
Motor Neuron	LABEL=Cell
Anterior Horn Cell	LABEL=Cell
Gamma Motor Neuron	LABEL=Cell
Nitrergic Neuron	LABEL=Cell
Purkinje Cell	LABEL=Cell
Purkinje Cell Layer of the Cerebellum	LABEL=Tissue
Oxyphil Cell	LABEL=Cell
Positive Regulation of Platelet Aggregation Process	LABEL=AssociatedBiologicalProcess
APUD Cell	LABEL=Cell
Pericyte	LABEL=Cell
Mucus-Secreting Cell	LABEL=Cell
Suprapubic Skin	LABEL=Tissue
Bartholin Gland	LABEL=Tissue
Type 1 Regulatory T-Cell	LABEL=Cell
Peristomal Skin	LABEL=Tissue
Intrahepatic Bile Duct	LABEL=Tissue
Chemotaxis Inhibition	LABEL=AssociatedBiologicalProcess
Bronchial Tree	LABEL=Tissue
Pulmonary Lobule	LABEL=Tissue
Common Bile Duct	LABEL=Tissue
Extrahepatic Bile Duct	LABEL=Tissue
Leukocyte Trafficking Inhibition	LABEL=AssociatedBiologicalProcess
Germinal Center B-Lymphocyte	LABEL=Cell
Skin Tissue	LABEL=Tissue
Myelin Sheath	LABEL=Tissue
Ectoderm	LABEL=Tissue
Germinal Layer	LABEL=Tissue
Gland	LABEL=Tissue
Endoderm	LABEL=Tissue
Corneal Endothelium	LABEL=Tissue
Negative Regulation of G1 to S Transition	LABEL=AssociatedBiologicalProcess
Acidophilic Cell	LABEL=Cell
Renal Cortex	LABEL=Tissue
Renal Medulla	LABEL=Tissue
Mesoderm	LABEL=Tissue
Nose	LABEL=Tissue
Parathyroid Gland	LABEL=Tissue
Peyer Patch	LABEL=Tissue
Gut-Associated Lymphoid Tissue	LABEL=Tissue
Seminal Vesicle	LABEL=Tissue
Consensus PCR	LABEL=ResearchTechnique
Nested PCR	LABEL=ResearchTechnique
Vas Deferens	LABEL=Tissue
Decipher Prostate Cancer Test	LABEL=ResearchTechnique
Molecular Profiling	LABEL=ResearchTechnique
Interferon-Gamma Release Assay	LABEL=ResearchTechnique
Immune Cell Function Assay	LABEL=ResearchTechnique
CD16+ CD56+ CD69+ Lymphocyte	LABEL=Cell
Squamous Epithelium	LABEL=Tissue
Squamous Cell	LABEL=Cell
Female Breast	LABEL=Tissue
Left Seminal Vesicle	LABEL=Tissue
Right Seminal Vesicle	LABEL=Tissue
Transitional Cell	LABEL=Cell
Transitional Epithelium	LABEL=Tissue
Alveolar Epithelium	LABEL=Tissue
GenomePlex Whole Genome Amplification	LABEL=ResearchTechnique
Whole Genome Amplification	LABEL=ResearchTechnique
REPLI-g Whole Genome Amplification	LABEL=ResearchTechnique
RNA Isolation	LABEL=ResearchTechnique
Urothelium	LABEL=Tissue
Renal Pyramid	LABEL=Tissue
Cellular Tropism	LABEL=AssociatedBiologicalProcess
Meningeal Layer of the Dura Mater	LABEL=Tissue
Palpebral Conjunctiva	LABEL=Tissue
Bulbar Conjunctiva	LABEL=Tissue
Supraclavicular Lymph Node	LABEL=Tissue
Mucosa-Associated Lymphoid Tissue	LABEL=Tissue
Small Cleaved Follicle Center Cell	LABEL=Cell
Activated B-Lymphocyte	LABEL=Cell
Blast Cell	LABEL=Cell
EBV-Specific Cytotoxic T-Lymphocyte	LABEL=Cell
Large Granular Lymphocyte	LABEL=Cell
Corneal Epithelium	LABEL=Tissue
Stratified Epithelium	LABEL=Tissue
Mammary Epithelium	LABEL=Tissue
Mature Lymphocyte	LABEL=Cell
Autologous Lymphocyte	LABEL=Cell
Mitotic Catastrophe	LABEL=AssociatedBiologicalProcess
Leptomeninges	LABEL=Tissue
mRNA Sequencing	LABEL=ResearchTechnique
Medial Supraclavicular Lymph Node	LABEL=Tissue
Peripheral Blood Stem Cell	LABEL=Cell
Sentinel Lymph Node	LABEL=Tissue
Somatic Cell	LABEL=Cell
Embryonic Tissue	LABEL=Tissue
Fibrous Tissue	LABEL=Tissue
Peripheral Blood Mononuclear Cell	LABEL=Cell
Liver Stem Cell	LABEL=Cell
White Blood Cell Lysis	LABEL=AssociatedBiologicalProcess
Cytolytic Process	LABEL=AssociatedBiologicalProcess
Peripheral Nerve Sheath	LABEL=Tissue
Nerve Sheath	LABEL=Tissue
Serum Protein Electrophoresis	LABEL=ResearchTechnique
Electrophoresis	LABEL=ResearchTechnique
Total RNA Expression Profile	LABEL=ResearchTechnique
MicroRNA Expression Profile	LABEL=ResearchTechnique
Tumor cDNA Expression Profile	LABEL=ResearchTechnique
cDNA Expression	LABEL=ResearchTechnique
Interval Lymph Node	LABEL=Tissue
Neural Stem Cell	LABEL=Cell
Epigenetic Profile	LABEL=ResearchTechnique
Single Nucleotide Polymorphism Profile	LABEL=ResearchTechnique
Short Tandem Repeat Profile	LABEL=ResearchTechnique
Episclera	LABEL=Tissue
Promoter-specific Methylation Profile	LABEL=ResearchTechnique
Hypermethylation Profile	LABEL=ResearchTechnique
Hypomethylation Profile	LABEL=ResearchTechnique
Red Cell Fatty Acid Profile	LABEL=ResearchTechnique
Genome-Wide Allelic Status	LABEL=ResearchTechnique
Global DNA Methylation Profile	LABEL=ResearchTechnique
Natural Killer T-Cell	LABEL=Cell
Myeloid-Derived Suppressor Cell	LABEL=Cell
Neuroblast	LABEL=Cell
Neuroectodermal Cell	LABEL=Cell
Splenic Red Pulp	LABEL=Tissue
Splenic Pulp	LABEL=Tissue
Splenic White Pulp	LABEL=Tissue
Thymic Lymphoid Tissue	LABEL=Tissue
Rhabdomyocyte	LABEL=Cell
Striated Muscle Cell	LABEL=Cell
Ependymal Cell	LABEL=Cell
Ependyma and Remnants of the Central Canal of the Spinal Cord	LABEL=Tissue
Pericardium	LABEL=Tissue
Brunner's Gland	LABEL=Tissue
Lymphoid Blood-Forming Cell	LABEL=Cell
Lymphoblast	LABEL=Cell
Immature Lymphocyte	LABEL=Cell
Monoblast	LABEL=Cell
Myeloblast	LABEL=Cell
High Resolution Melt Analysis	LABEL=ResearchTechnique
Next Generation Targeted Sequencing	LABEL=ResearchTechnique
Allele Specific Primer Polymerase Chain Reaction	LABEL=ResearchTechnique
Sequence-based Typing	LABEL=ResearchTechnique
Sequence-specific Oligonucleotide Probe Polymerase Chain Reaction	LABEL=ResearchTechnique
Single-strand Conformation Polymerase Chain Reaction	LABEL=ResearchTechnique
Nephron	LABEL=Tissue
Nerve Tissue and Nerve Sheaths	LABEL=Tissue
Tunica Intima	LABEL=Tissue
Synovial Cell	LABEL=Cell
Bone Tissue	LABEL=Tissue
Acinar Cell	LABEL=Cell
Ependyma	LABEL=Tissue
Prostatic Muscular Tissue	LABEL=Tissue
Prostatic Stroma	LABEL=Tissue
Male Urethra	LABEL=Tissue
Prostatic Duct	LABEL=Tissue
Prostatic Epithelium	LABEL=Tissue
Prostatic Tissue	LABEL=Tissue
Circulating Tumor-Reactive T-Cell	LABEL=Cell
Immature Granulocyte	LABEL=Cell
Promyelocyte	LABEL=Cell
Myelocyte	LABEL=Cell
Metamyelocyte	LABEL=Cell
Band Cell	LABEL=Cell
Prolymphocyte	LABEL=Cell
Immature Monocyte	LABEL=Cell
Promonocyte	LABEL=Cell
Megakaryoblast	LABEL=Cell
Memory B-Lymphocyte	LABEL=Cell
Epithelial Reticular Cell	LABEL=Cell
Immature Platelet	LABEL=Cell
Cartilaginous Tissue	LABEL=Tissue
Proerythroblast	LABEL=Cell
Basophilic Erythroblast	LABEL=Cell
Polychromatic Erythroblast	LABEL=Cell
Orthochromatic Erythroblast	LABEL=Cell
Club Cell	LABEL=Cell
Bronchial Epithelium	LABEL=Tissue
Squamous Alveolar Lining Cell	LABEL=Cell
Alveolar Cell	LABEL=Cell
Epithelial Receptor Cell	LABEL=Cell
Taste Bud Cell	LABEL=Cell
Light Cell	LABEL=Cell
Type III Epithelial Receptor Cell	LABEL=Cell
Olfactory Epithelial Cell	LABEL=Cell
Olfactory Epithelium	LABEL=Tissue
Olfactory Receptor Cell	LABEL=Cell
Bipolar Neuron	LABEL=Cell
Olfactory Mucosa	LABEL=Tissue
Olfactory Supporting Cell	LABEL=Cell
Remnants of the Central Canal of the Spinal Cord	LABEL=Tissue
Olfactory Basal Cell	LABEL=Cell
Receptor Cell	LABEL=Cell
Intestinal Smooth Muscle Tissue	LABEL=Tissue
Cuboidal Cell	LABEL=Cell
Cuboidal Epithelium	LABEL=Tissue
Columnar Cell	LABEL=Cell
Columnar Epithelium	LABEL=Tissue
Mesangial Cell	LABEL=Cell
Mesangium	LABEL=Tissue
Juxtaglomerular Cell	LABEL=Cell
Juxtaglomerular Apparatus	LABEL=Tissue
Submucosa	LABEL=Tissue
Serosa	LABEL=Tissue
Hassall's Corpuscle	LABEL=Tissue
Pigment Epithelium	LABEL=Tissue
Simple Squamous Epithelium	LABEL=Tissue
Simple Epithelium	LABEL=Tissue
Basilar Membrane	LABEL=Tissue
Stratified Squamous Epithelium	LABEL=Tissue
Pseudostratified Columnar Ciliated Epithelium	LABEL=Tissue
Pseudostratified Columnar Epithelium	LABEL=Tissue
Endosteum	LABEL=Tissue
Periosteum	LABEL=Tissue
Taste Bud Basal Cell	LABEL=Cell
Unspecified Tissue	LABEL=Tissue
Esophageal Epithelium	LABEL=Tissue
Diaphragmatic Lymph Node	LABEL=Tissue
Neck Lymph Node Groups	LABEL=Tissue
Submental Lymph Node Group (Sublevel IA)	LABEL=Tissue
Submandibular Lymph Node Group (Sublevel IB)	LABEL=Tissue
Upper Jugular Lymph Node Group (Sublevels IIA and IIB)	LABEL=Tissue
Middle Jugular Lymph Node Group (Level III)	LABEL=Tissue
Lower Jugular Lymph Node Group (Level IV)	LABEL=Tissue
Posterior Triangle Lymph Node Group (Sublevels VA and VB)	LABEL=Tissue
Anterior Compartment Lymph Node Group (Level VI)	LABEL=Tissue
Superior Mediastinal Lymph Node Group (Level VII)	LABEL=Tissue
Mullerian Duct	LABEL=Tissue
Respiratory Pathogen Panel	LABEL=ResearchTechnique
Herpes Simplex Virus 1 DNA (Presence)	LABEL=ResearchTechnique
Herpes Simplex Virus 2 DNA (Presence)	LABEL=ResearchTechnique
Herpes Virus 6 DNA (Presence)	LABEL=ResearchTechnique
Mesenchyme	LABEL=Tissue
Embryonic Connective Tissue	LABEL=Tissue
Myoepithelial Cell	LABEL=Cell
Derived Placental Blood Cell	LABEL=Cell
Demineralized Bone Tissue	LABEL=Tissue
Inner Membrane Amniotic Membrane Tissue	LABEL=Tissue
Umbilical Cord Tissue	LABEL=Tissue
Hematopoietic Progenitor Cells from Apheresis	LABEL=Cell
Hematopoietic Progenitor Cells from Cord Blood	LABEL=Cell
Heart Valve Tissue	LABEL=Tissue
Non-Valve Cardiac Conduit Tissue	LABEL=Tissue
Ocular Tissue	LABEL=Tissue
Placenta Tissue without Amniotic Elements	LABEL=Tissue
Lymphoid Follicle	LABEL=Tissue
Allogeneic Lymphocyte	LABEL=Cell
Regulation of Nuclear Division	LABEL=AssociatedBiologicalProcess
Deoxyribonucleic Acid Measurement	LABEL=ResearchTechnique
Accelerator Mass Spectrometry	LABEL=ResearchTechnique
Freezing Point Depression	LABEL=ResearchTechnique
Gas Chromatography and Flame Ionization Detection	LABEL=ResearchTechnique
Population Sequencing	LABEL=ResearchTechnique
Gene Expression Level Analysis	LABEL=ResearchTechnique
Genetic Sub-Region Sequence	LABEL=ResearchTechnique
Predicted Single Nucleotide Polymorphism Frequency	LABEL=ResearchTechnique
Genetic Sequence Length	LABEL=ResearchTechnique
Genetic Sequence Start Location	LABEL=ResearchTechnique
Urine Protein Electrophoresis	LABEL=ResearchTechnique
Urine Immunofixation Electrophoresis	LABEL=ResearchTechnique
Immunofixation	LABEL=ResearchTechnique
Serum Immunofixation Electrophoresis	LABEL=ResearchTechnique
Determination of Tumor DNA Mismatch Repair Status	LABEL=ResearchTechnique
Intramammary Lymph Node	LABEL=Tissue
Blood Vessel Tissue	LABEL=Tissue
Ovarian Tissue	LABEL=Tissue
Epstein-Barr Encoding Region in situ Hybridization	LABEL=ResearchTechnique
In Situ Hybridization	LABEL=ResearchTechnique
Mantle Zone	LABEL=Tissue
Peripheral B-Lymphocyte of Inner Mantle Zone	LABEL=Cell
Derived Synovial Fluid Cell	LABEL=Cell
Derived Peripheral Blood Mononuclear Cell	LABEL=Cell
Derived Dental Pulp	LABEL=Cell
Epigastric Lymph Node	LABEL=Tissue
Esophageal Lymph Node	LABEL=Tissue
Gingival Mucosa	LABEL=Tissue
Iliotibial Band	LABEL=Tissue
A260 to A280 Ratio	LABEL=ResearchTechnique
A260 to A230 Ratio	LABEL=ResearchTechnique
Percent of Nucleotide Markers Exhibiting Instability	LABEL=ResearchTechnique
Microsatellite Instability Analysis	LABEL=ResearchTechnique
Microsatellite Instability Overall Status	LABEL=ResearchTechnique
Microsatellite Stability Assessment	LABEL=ResearchTechnique
RAS Protein Family Activation Assay	LABEL=ResearchTechnique
In Vitro Assay	LABEL=ResearchTechnique
M Phase Process	LABEL=AssociatedBiologicalProcess
Cell Maintenance	LABEL=AssociatedBiologicalProcess
Oncotype DX Genomic Prostate Score	LABEL=ResearchTechnique
Nuchal Lymph Node	LABEL=Tissue
Parapharyngeal Lymph Node	LABEL=Tissue
Retroauricular Lymph Node	LABEL=Tissue
Skin Between the Eyebrows	LABEL=Tissue
Skin Of The Back	LABEL=Tissue
Skin Of The Chin	LABEL=Tissue
Splenic Lymph Node	LABEL=Tissue
Submental Lymph Node	LABEL=Tissue
Clauss Method	LABEL=ResearchTechnique
Kinetic Chromogenic Assay	LABEL=ResearchTechnique
Micro-Latex Particle-Mediated Immunoassay	LABEL=ResearchTechnique
Potentiometry	LABEL=ResearchTechnique
Silver-Enhanced in Situ Hybridization	LABEL=ResearchTechnique
BRCA Mutation Analysis	LABEL=ResearchTechnique
Genetic Variation Analysis	LABEL=ResearchTechnique
454 Sequencing	LABEL=ResearchTechnique
ABI SOLiD Sequencing	LABEL=ResearchTechnique
BGISEQ-500 Sequencing	LABEL=ResearchTechnique
Capillary Sequencing	LABEL=ResearchTechnique
Complete Genomics Sequencing	LABEL=ResearchTechnique
Helicos Sequencing	LABEL=ResearchTechnique
Illumina Sequencing	LABEL=ResearchTechnique
Oxford Nanopore Sequencing	LABEL=ResearchTechnique
SMRT Sequencing	LABEL=ResearchTechnique
Paralaryngeal Lymph Node	LABEL=Tissue
Prelaryngeal Lymph Node	LABEL=Tissue
Pretracheal Lymph Node	LABEL=Tissue
T-Cell Differentiation in the Thymus	LABEL=AssociatedBiologicalProcess
Prolaris Prostate Cancer Testing	LABEL=ResearchTechnique
Skeletal Muscle Cell	LABEL=Cell
Ecological Momentary Assessment	LABEL=ResearchTechnique
Gastric Mucosa	LABEL=Tissue
Paired-End Sequencing	LABEL=ResearchTechnique
Second-strand Library Sequencing	LABEL=ResearchTechnique
Unstranded Library Sequencing	LABEL=ResearchTechnique
First-strand Library Sequencing	LABEL=ResearchTechnique
Skin of the Buttock	LABEL=Tissue
Microdensitometry	LABEL=ResearchTechnique
Densitometry	LABEL=ResearchTechnique
Draining Lymph Node	LABEL=Tissue
Regional Lymph Node	LABEL=Tissue
G1 to S Transition Process	LABEL=AssociatedBiologicalProcess
Cell-free System	LABEL=ResearchTechnique
Metaphase Process	LABEL=AssociatedBiologicalProcess
Guardant360	LABEL=ResearchTechnique
Molecular Diagnostic Method	LABEL=ResearchTechnique
Hematopoietic Immune Cell	LABEL=Cell
Caris Molecular Intelligence Tumor Profiling	LABEL=ResearchTechnique
Nucleotide Sequence Read	LABEL=ResearchTechnique
Sequence Analysis	LABEL=ResearchTechnique
Read Length	LABEL=ResearchTechnique
Tumor-Infiltrating Immune Cell	LABEL=Cell
DNA Sequencing	LABEL=ResearchTechnique
ADCC Assay	LABEL=ResearchTechnique
ExoDx Prostate Intelliscore	LABEL=ResearchTechnique
Main Pancreatic and Accessory Ducts	LABEL=Tissue
Buccal Lymph Node	LABEL=Tissue
Gastric Curvature Lymph Node	LABEL=Tissue
Perirectal Lymph Node	LABEL=Tissue
Presacral Lymph Node	LABEL=Tissue
Prefrontal Cortex	LABEL=Tissue
Enzymatic Spectrophotometry	LABEL=ResearchTechnique
Oscillometry	LABEL=ResearchTechnique
Secondary Ion Mass Spectrometry	LABEL=ResearchTechnique
Immunochromatography	LABEL=ResearchTechnique
Chromatography	LABEL=ResearchTechnique
Automated Count	LABEL=ResearchTechnique
Manual Count	LABEL=ResearchTechnique
Westergren Tube Method	LABEL=ResearchTechnique
Impedance Conductivity	LABEL=ResearchTechnique
Skin of the Extremity	LABEL=Tissue
Fibroadipose Tissue	LABEL=Tissue
Influenza Virus-Specific Culture	LABEL=ResearchTechnique
Myeloid Mutation Panel	LABEL=ResearchTechnique
Mutation Detection	LABEL=ResearchTechnique
M1 Macrophage	LABEL=Cell
ATAC-Seq	LABEL=ResearchTechnique
MicroRNA Sequencing	LABEL=ResearchTechnique
Genetic Testing for Cancer Risk	LABEL=ResearchTechnique
Genetic Testing	LABEL=ResearchTechnique
Alpha/Beta T-Lymphocyte	LABEL=Cell
Bone Marrow Mononuclear Cell	LABEL=Cell
Marginal Zone	LABEL=Tissue
AssureMDx	LABEL=ResearchTechnique
Proximity Ligation Assay	LABEL=ResearchTechnique
Protein Analysis	LABEL=ResearchTechnique
1p/19q Codeletion Status	LABEL=ResearchTechnique
Cytogenetic Analysis	LABEL=ResearchTechnique
ATRX Mutation Status by Sequencing	LABEL=ResearchTechnique
ATRX Mutation Analysis	LABEL=ResearchTechnique
BAP1 Mutation Analysis	LABEL=ResearchTechnique
BRAF Mutation Analysis	LABEL=ResearchTechnique
CDH1 Mutation Analysis	LABEL=ResearchTechnique
CTNNB1 Mutation Analysis	LABEL=ResearchTechnique
ERBB2 Mutation Analysis	LABEL=ResearchTechnique
FGFR1 Mutation Analysis	LABEL=ResearchTechnique
FGFR2 Mutation Analysis	LABEL=ResearchTechnique
FGFR3 Mutation Analysis	LABEL=ResearchTechnique
GNA11 Mutation Analysis	LABEL=ResearchTechnique
GNAQ Mutation Analysis	LABEL=ResearchTechnique
HRAS Mutation Analysis	LABEL=ResearchTechnique
IDH1/IDH2 Mutation Analysis	LABEL=ResearchTechnique
IDH1/2 Mutation Status by Sequencing	LABEL=ResearchTechnique
NRAS Mutation Analysis	LABEL=ResearchTechnique
BRAF Rearrangement Analysis	LABEL=ResearchTechnique
Gene Rearrangement Analysis	LABEL=ResearchTechnique
ERG Rearrangement Analysis	LABEL=ResearchTechnique
ETV Rearrangement Analysis	LABEL=ResearchTechnique
FGFR1 Rearrangement Analysis	LABEL=ResearchTechnique
FGFR2 Rearrangement Analysis	LABEL=ResearchTechnique
FGFR3 Rearrangement Analysis	LABEL=ResearchTechnique
PAX8 Rearrangement Analysis	LABEL=ResearchTechnique
RET Rearrangement Analysis	LABEL=ResearchTechnique
Cell Expansion	LABEL=ResearchTechnique
Pegylation	LABEL=ResearchTechnique
TERT Promoter Mutation Analysis	LABEL=ResearchTechnique
TP53 Mutation Status by Sequencing	LABEL=ResearchTechnique
TP53 Mutation Analysis	LABEL=ResearchTechnique
ERBB2 Amplification Status	LABEL=ResearchTechnique
MET Amplification Status	LABEL=ResearchTechnique
PALB2 Mutation Analysis	LABEL=ResearchTechnique
Somatic Mutation Analysis	LABEL=ResearchTechnique
Somatic Cell Genetics	LABEL=ResearchTechnique
Esophageal Manometry	LABEL=ResearchTechnique
Manometry	LABEL=ResearchTechnique
Deep Gray Matter	LABEL=Tissue
Restraint	LABEL=ResearchTechnique
Thermal Ionization Mass Spectrometry	LABEL=ResearchTechnique
Immune Repertoire Deep Sequencing	LABEL=ResearchTechnique
Multiplex Real-time Polymerase Chain Reaction Assay	LABEL=ResearchTechnique
Targeted Transcriptome Sequencing	LABEL=ResearchTechnique
Targeted Genome Sequencing	LABEL=ResearchTechnique
Chemical Restraint	LABEL=ResearchTechnique
Physical Restraint	LABEL=ResearchTechnique
Chemical and Physical Restraint	LABEL=ResearchTechnique
Negative Regulation of G0 to G1 Transition	LABEL=AssociatedBiologicalProcess
Myeloid Stem Cell	LABEL=Cell
del(10q23)/PTEN Gene Locus Deletion Analysis	LABEL=ResearchTechnique
EGFR Amplification Status	LABEL=ResearchTechnique
EGFR Mutation Analysis	LABEL=ResearchTechnique
KIT Mutation Analysis	LABEL=ResearchTechnique
MET Mutation Analysis	LABEL=ResearchTechnique
NF1 Mutation Analysis	LABEL=ResearchTechnique
PDGFRA Mutation Analysis	LABEL=ResearchTechnique
PTEN Mutation Analysis	LABEL=ResearchTechnique
ROS1 Rearrangement Analysis	LABEL=ResearchTechnique
SDH Complex Mutation Analysis	LABEL=ResearchTechnique
Renomedullary Interstitial Cell	LABEL=Cell
Interstitial Cell	LABEL=Cell
Pelvic Peritoneum	LABEL=Tissue
Abdominal Peritoneum	LABEL=Tissue
Dual-probe in Situ Hybridization	LABEL=ResearchTechnique
ALK Rearrangement Analysis	LABEL=ResearchTechnique
MLH1 Gene Promoter Hypermethylation Status	LABEL=ResearchTechnique
Coherent Anti-Stokes Raman Spectroscopy	LABEL=ResearchTechnique
Raman Spectroscopy	LABEL=ResearchTechnique
C51 Cytotoxicity Assay	LABEL=ResearchTechnique
Skin of the Forearm	LABEL=Tissue
Arm Skin	LABEL=Tissue
Skin of the Chest	LABEL=Tissue
Skin of the Inguinal Region	LABEL=Tissue
Skin of the Infrascapular Region	LABEL=Tissue
Keratinization	LABEL=AssociatedBiologicalProcess
Cellular Process	LABEL=AssociatedBiologicalProcess
1-Dimensional Chromatography	LABEL=ResearchTechnique
Fixed Lymph Node	LABEL=Tissue
2-Dimensional Chromatography	LABEL=ResearchTechnique
3-Dimensional Chromatography	LABEL=ResearchTechnique
Reversed-Phase Liquid Chromatography	LABEL=ResearchTechnique
Affinity Chromatography	LABEL=ResearchTechnique
Basic Reversed-Phase Liquid Chromatography	LABEL=ResearchTechnique
pH 7.5 Basic Reversed-Phase Liquid Chromatography	LABEL=ResearchTechnique
pH 10 Basic Reversed-Phase Liquid Chromatography	LABEL=ResearchTechnique
Strong-Cation-Exchange Chromatography	LABEL=ResearchTechnique
2-Dimensional Reversed-Phase Liquid Chromatography	LABEL=ResearchTechnique
Higher-Energy Collisional Dissociation	LABEL=ResearchTechnique
Electron-Transfer Dissociation	LABEL=ResearchTechnique
Electron-Capture Dissociation	LABEL=ResearchTechnique
Immobilized Metal Affinity Chromatography	LABEL=ResearchTechnique
Immobilized Metal Affinity Chromatography with Phosphopeptide Enrichment	LABEL=ResearchTechnique
MS3	LABEL=ResearchTechnique
Label-Free Mass Spectrometry	LABEL=ResearchTechnique
Isobaric Peptide Termini Labeling	LABEL=ResearchTechnique
Isotope-Coded Protein Label	LABEL=ResearchTechnique
Stable Isotope Labeling with Amino Acids in Cell Culture	LABEL=ResearchTechnique
No Protein Cleavage Reagent Used	LABEL=ResearchTechnique
Protein Digestion	LABEL=ResearchTechnique
No Cleavage Enzyme Used	LABEL=ResearchTechnique
Unspecified Cleavage Reagents Used	LABEL=ResearchTechnique
Thymic Epithelial Tissue	LABEL=Tissue
Thymic Epithelial Cell	LABEL=Cell
Paratesticular Soft Tissue	LABEL=Tissue
cobas MPX Test	LABEL=ResearchTechnique
ProMark Proteomic Prognostic Test	LABEL=ResearchTechnique
Protein Expression Analysis by Immunohistochemistry	LABEL=ResearchTechnique
Protein Expression Analysis	LABEL=ResearchTechnique
Anaphase	LABEL=AssociatedBiologicalProcess
BrdU Cellular Proliferation Assay	LABEL=ResearchTechnique
Northern Blotting	LABEL=ResearchTechnique
RNA Analysis	LABEL=ResearchTechnique
Southern Blotting	LABEL=ResearchTechnique
Western Blotting	LABEL=ResearchTechnique
Tissue Culture	LABEL=ResearchTechnique
Colonic Mucosa	LABEL=Tissue
Large Intestinal Mucosa	LABEL=Tissue
Mediastinal Soft Tissue	LABEL=Tissue
Nasal Soft Tissue	LABEL=Tissue
Periorbital Soft Tissue	LABEL=Tissue
Cell Fusion	LABEL=ResearchTechnique
Cell Growth Process	LABEL=AssociatedBiologicalProcess
Cell Maturation	LABEL=AssociatedBiologicalProcess
Skin of the Lower Extremity	LABEL=Tissue
Skin of the Upper Extremity	LABEL=Tissue
Aligned Sequence Read	LABEL=ResearchTechnique
Unaligned Sequence Read	LABEL=ResearchTechnique
Cell Viability Process	LABEL=AssociatedBiologicalProcess
Biomolecule Separation Technology	LABEL=ResearchTechnique
Density Gradient Centrifugation	LABEL=ResearchTechnique
PTGS2 c.-765G/C Polymorphism Profile	LABEL=ResearchTechnique
Column Chromatography	LABEL=ResearchTechnique
Gel Filtration Chromatography	LABEL=ResearchTechnique
Chromosome Banding	LABEL=ResearchTechnique
Gene Mapping	LABEL=ResearchTechnique
Cloning	LABEL=ResearchTechnique
Gene Cloning	LABEL=ResearchTechnique
Crystallography	LABEL=ResearchTechnique
Genotyping Array	LABEL=ResearchTechnique
DNA Microarray Analysis	LABEL=ResearchTechnique
Low-Pass Whole Genome Sequencing	LABEL=ResearchTechnique
Low-Coverage Whole Genome Sequencing	LABEL=ResearchTechnique
DNA Methylation Array	LABEL=ResearchTechnique
Microarray Analysis	LABEL=ResearchTechnique
Decipher Bladder Cancer Assay	LABEL=ResearchTechnique
Electron Spin Resonance Spectroscopy	LABEL=ResearchTechnique
Agarose Gel Electrophoresis	LABEL=ResearchTechnique
Gel Electrophoresis	LABEL=ResearchTechnique
Two Dimensional Gel Electrophoresis	LABEL=ResearchTechnique
Polyacrylamide Gel Electrophoresis	LABEL=ResearchTechnique
Indexed Sequencing	LABEL=ResearchTechnique
Single-indexed Sequencing	LABEL=ResearchTechnique
Dual-indexed Sequencing	LABEL=ResearchTechnique
Epidemiological Method	LABEL=ResearchTechnique
Extra-Abdominal Lymph Node	LABEL=Tissue
Tumor Panel Sequencing	LABEL=ResearchTechnique
Selected Suppression	LABEL=ResearchTechnique
Vibrio cholerae, Vibrio parahaemolyticus, and/or Vibrio vulnificus DNA Measurement	LABEL=ResearchTechnique
Shigella and/or Enteroinvasive Escherichia coli ipaH DNA Measurement	LABEL=ResearchTechnique
Enterotoxigenic Escherichia coli LtA, ST1a, and/or ST1b DNA Measurement	LABEL=ResearchTechnique
Enteropathogenic Escherichia coli eae DNA Measurement	LABEL=ResearchTechnique
Enteroaggregative Escherichia coli pAA Plasmid aggR and/or aatA DNA Measurement	LABEL=ResearchTechnique
Campylobacter coli, Campylobacter jejuni and/or Campylobacter upsaliensis DNA Measurement	LABEL=ResearchTechnique
Human adenovirus 40 and/or Human adenovirus 41 DNA Measurement	LABEL=ResearchTechnique
Cyclospora cayetanensis DNA Measurement	LABEL=ResearchTechnique
Cryptosporidium DNA Measurement	LABEL=ResearchTechnique
Epstein-Barr DNA Measurement	LABEL=ResearchTechnique
Entamoeba histolytica DNA Measurement	LABEL=ResearchTechnique
Escherichia coli O157 DNA Measurement	LABEL=ResearchTechnique
Giardia lamblia DNA Measurement	LABEL=ResearchTechnique
Lactobacillus crispatus DNA Measurement	LABEL=ResearchTechnique
Plesiomonas shigelloides DNA Measurement	LABEL=ResearchTechnique
Salmonella enterica and/or Salmonella bongori DNA Measurement	LABEL=ResearchTechnique
Vibrio cholerae DNA Measurement	LABEL=ResearchTechnique
Yersinia enterocolitica DNA Measurement	LABEL=ResearchTechnique
Digital Polymerase Chain Reaction	LABEL=ResearchTechnique
Droplet Digital PCR	LABEL=ResearchTechnique
Multiplexed Digital Gene Expression Analysis	LABEL=ResearchTechnique
Gene Expression Analysis	LABEL=ResearchTechnique
Genetic Technique	LABEL=ResearchTechnique
Cxbladder	LABEL=ResearchTechnique
Reduced-Representation Bisulfite Sequencing	LABEL=ResearchTechnique
Interphase Process	LABEL=AssociatedBiologicalProcess
Isoelectric Focusing	LABEL=ResearchTechnique
Karyotyping	LABEL=ResearchTechnique
Genetic Linkage Analysis	LABEL=ResearchTechnique
Magnetic Resonance Spectroscopy	LABEL=ResearchTechnique
Elective Plasma-based CancerSEEK Testing	LABEL=ResearchTechnique
FLT3-Internal Tandem Duplication Allelic Ratio	LABEL=ResearchTechnique
Nucleic Acid Hybridization	LABEL=ResearchTechnique
Organ Culture	LABEL=ResearchTechnique
Peptide Synthesis	LABEL=ResearchTechnique
Pulse Radiolysis	LABEL=ResearchTechnique
Restriction Enzyme Analysis	LABEL=ResearchTechnique
Sister Chromatid Exchange Process	LABEL=AssociatedBiologicalProcess
Spectrometry	LABEL=ResearchTechnique
Negative Regulation of S Phase	LABEL=AssociatedBiologicalProcess
Telophase	LABEL=AssociatedBiologicalProcess
Transfection	LABEL=ResearchTechnique
DNA Fingerprinting	LABEL=ResearchTechnique
Fluorescence Activated Cell Sorting	LABEL=ResearchTechnique
G2 Phase Process	LABEL=AssociatedBiologicalProcess
Mutagenesis	LABEL=ResearchTechnique
Insertional Mutagenesis	LABEL=ResearchTechnique
Site-Directed Mutagenesis	LABEL=ResearchTechnique
Pulsed-Field Gel Electrophoresis	LABEL=ResearchTechnique
Thymic T-Cell Selection	LABEL=AssociatedBiologicalProcess
Cell Ontogeny	LABEL=AssociatedBiologicalProcess
Fluorescence In Situ Hybridization	LABEL=ResearchTechnique
Myeloproliferation	LABEL=AssociatedBiologicalProcess
Restriction Fragment Length Polymorphism Analysis	LABEL=ResearchTechnique
Polymorphism Analysis	LABEL=ResearchTechnique
Capillary Electrophoresis	LABEL=ResearchTechnique
X-Ray Crystallography	LABEL=ResearchTechnique
Fluorescence Spectroscopy	LABEL=ResearchTechnique
Gene Targeting	LABEL=ResearchTechnique
DNA Footprinting	LABEL=ResearchTechnique
Blast Cell Proliferation	LABEL=AssociatedBiologicalProcess
Comparative Genomic Hybridization	LABEL=ResearchTechnique
Representational Difference Analysis	LABEL=ResearchTechnique
Microdissection	LABEL=ResearchTechnique
Microtechnique	LABEL=ResearchTechnique
Reverse Transcriptase-Polymerase Chain Reaction	LABEL=ResearchTechnique
Yeast One/Two-Hybrid System	LABEL=ResearchTechnique
Expression Technologies for DNA and RNA	LABEL=ResearchTechnique
Tandem Mass Spectrometry	LABEL=ResearchTechnique
Gene Knockout	LABEL=ResearchTechnique
Sodium Dodecylsulfate-Polyacrylamide Gel Electrophoresis	LABEL=ResearchTechnique
Chromosome Painting	LABEL=ResearchTechnique
DNA Ploidy Analysis	LABEL=ResearchTechnique
Tumor Replication Error Analysis	LABEL=ResearchTechnique
Megakaryocyte Proliferation	LABEL=AssociatedBiologicalProcess
Serial Analysis of Gene Expression	LABEL=ResearchTechnique
Differential Display	LABEL=ResearchTechnique
Biotechnology, Mass Cell Culture	LABEL=ResearchTechnique
cDNA Library Construction	LABEL=ResearchTechnique
cDNA Subtraction	LABEL=ResearchTechnique
Chromosome Rearrangement Detection	LABEL=ResearchTechnique
Chromosome Transfer	LABEL=ResearchTechnique
Analytical Centrifugation	LABEL=ResearchTechnique
Elutriative Centrifugation	LABEL=ResearchTechnique
Preparative Centrifugation	LABEL=ResearchTechnique
Chemical Fractionation	LABEL=ResearchTechnique
Gene Mapping, Human	LABEL=ResearchTechnique
Gene Mapping, Non-Human	LABEL=ResearchTechnique
Protein Sequencing	LABEL=ResearchTechnique
Optical Methods	LABEL=ResearchTechnique
Phage Display	LABEL=ResearchTechnique
Photometry/Spectrum Analysis, Visible Light	LABEL=ResearchTechnique
Photometry/Spectrum Analysis, X-ray/Neutron	LABEL=ResearchTechnique
Phylogenetic Analysis	LABEL=ResearchTechnique
Post Translational Modification Analysis	LABEL=ResearchTechnique
Spectroscopy, Circular Dichroism	LABEL=ResearchTechnique
TTA System	LABEL=ResearchTechnique
Whole Organism Cloning	LABEL=ResearchTechnique
Antisense Technology	LABEL=ResearchTechnique
Gene Amplification or Deletion Detection	LABEL=ResearchTechnique
SSCP Analysis	LABEL=ResearchTechnique
Conformation Dependent Mutation Detection	LABEL=ResearchTechnique
Dideoxy Fingerprinting	LABEL=ResearchTechnique
Deletion Mutagenesis	LABEL=ResearchTechnique
S1 Protection	LABEL=ResearchTechnique
DNA Ligation	LABEL=ResearchTechnique
Laser Capture Microdissection	LABEL=ResearchTechnique
Fetal Thymic Organ Culture	LABEL=ResearchTechnique
Magnetic Bead Separation	LABEL=ResearchTechnique
Immunoaffinity Chromatography	LABEL=ResearchTechnique
Primary Cell Culture	LABEL=ResearchTechnique
Reflectance or Transmission Spectroscopy	LABEL=ResearchTechnique
Culturing, In Vitro Invertebrate	LABEL=ResearchTechnique
Electrophoretic Mobility Shift Assay	LABEL=ResearchTechnique
Electrospray Ionization	LABEL=ResearchTechnique
Pathway Analysis	LABEL=ResearchTechnique
Equilibrium Centrifugation	LABEL=ResearchTechnique
Chemical Interference	LABEL=ResearchTechnique
G-Banding	LABEL=ResearchTechnique
R-Banding	LABEL=ResearchTechnique
Culturing, In Vitro Vertebrate, Tissue	LABEL=ResearchTechnique
Culturing, In Vitro Vertebrate, Cell	LABEL=ResearchTechnique
Baculovirus Expression System	LABEL=ResearchTechnique
Cocrystallography	LABEL=ResearchTechnique
Sister Chromatid Exchange Assay	LABEL=ResearchTechnique
Nuclear Transfer	LABEL=ResearchTechnique
Fiber FISH	LABEL=ResearchTechnique
Random Peptide Synthesis	LABEL=ResearchTechnique
Run-On Assays	LABEL=ResearchTechnique
DNA-Mediated Gene Transfer	LABEL=ResearchTechnique
Gene Transfer	LABEL=ResearchTechnique
Liposome-Mediated Gene Transfer	LABEL=ResearchTechnique
Atomic Resolution X-Ray Crystallography	LABEL=ResearchTechnique
Clone-Based Physical Mapping	LABEL=ResearchTechnique
Dideoxy Chain Termination DNA Sequencing	LABEL=ResearchTechnique
Shotgun Sequencing	LABEL=ResearchTechnique
Linkage Disequilibrium Mapping	LABEL=ResearchTechnique
Shotgun Sequence Assembly	LABEL=ResearchTechnique
Whole-Genome Shotgun Sequencing	LABEL=ResearchTechnique
YAC-Based STS-Content Mapping	LABEL=ResearchTechnique
YAC Cloning	LABEL=ResearchTechnique
Radioactive Sequencing	LABEL=ResearchTechnique
TdT-Mediated dUTP Nick End Labeling Assay	LABEL=ResearchTechnique
Allelotype Analysis	LABEL=ResearchTechnique
Short Oligonucleotide Mass Analysis	LABEL=ResearchTechnique
Metaphase Spread	LABEL=ResearchTechnique
Tissue Recombination	LABEL=ResearchTechnique
Gelatin Zymography	LABEL=ResearchTechnique
DNase-I Footprinting	LABEL=ResearchTechnique
Matrix-Assisted Laser Desorption/Ionization-Time of Flight Mass Spectrometry	LABEL=ResearchTechnique
Cell Membrane Process	LABEL=AssociatedBiologicalProcess
Molecular Fingerprinting of Tumor	LABEL=ResearchTechnique
Light-Scattering Spectroscopy	LABEL=ResearchTechnique
Cellular Compartment Analysis	LABEL=ResearchTechnique
Microdeposition	LABEL=ResearchTechnique
Microfabrication	LABEL=ResearchTechnique
Spectral Karyotyping	LABEL=ResearchTechnique
Genome Scan	LABEL=ResearchTechnique
Aptamer Technology	LABEL=ResearchTechnique
Tetracycline Control	LABEL=ResearchTechnique
Cell Cycle Phase	LABEL=AssociatedBiologicalProcess
Secondary Cell Culture	LABEL=ResearchTechnique
Adherent Culture	LABEL=ResearchTechnique
Suspension Culture	LABEL=ResearchTechnique
Replication Initiation Point Mapping	LABEL=ResearchTechnique
Gene Amplification Technique	LABEL=ResearchTechnique
Clonal Expansion	LABEL=AssociatedBiologicalProcess
Primer Extension	LABEL=ResearchTechnique
Somatic Cell Hybridization	LABEL=ResearchTechnique
Linker-Scanning Mutagenesis	LABEL=ResearchTechnique
Cell Cycle Completion	LABEL=AssociatedBiologicalProcess
Anchorage-Independent Growth	LABEL=ResearchTechnique
Glial Cell Proliferation	LABEL=AssociatedBiologicalProcess
cDNA Microarray Analysis	LABEL=ResearchTechnique
Cell Movement Process	LABEL=AssociatedBiologicalProcess
Dopaminergic Cell	LABEL=Cell
Islet Cell	LABEL=Cell
Lactiferous Duct	LABEL=Tissue
Mature Tissue Histiocyte	LABEL=Cell
Pluripotent Bone Marrow Stem Cell	LABEL=Cell
Multipotent Bone Marrow Stem Cell	LABEL=Cell
Thyroid Gland Follicle	LABEL=Tissue
Thyroid Gland Follicular Cell	LABEL=Cell
Gingiva	LABEL=Tissue
Esophageal Squamous Epithelium	LABEL=Tissue
Small Intestinal Glandular Cell	LABEL=Cell
Bronchial Epithelial Cell	LABEL=Cell
Bronchus-Associated Lymphoid Tissue	LABEL=Tissue
Thyroid Gland Tissue	LABEL=Tissue
Endocervical Mucosa	LABEL=Tissue
Endocervical Columnar Cell	LABEL=Cell
Endometrial Glandular Cell	LABEL=Cell
Bile Duct Epithelium	LABEL=Tissue
Activated Skin-Homing T-Lymphocyte	LABEL=Cell
Precursor T-Lymphoblast	LABEL=Cell
Precursor Natural Killer Cell	LABEL=Cell
Precursor B-Lymphoblast	LABEL=Cell
Terminal Ductal Lobular Unit Cell	LABEL=Cell
Delta Cell of the Pancreas	LABEL=Cell
Quantitative Reverse Transcriptase PCR	LABEL=ResearchTechnique
Subsegmental Lymph Node	LABEL=Tissue
Chondroblast	LABEL=Cell
Rathke Pouch Epithelium	LABEL=Tissue
Alpha Cell	LABEL=Cell
Peripheral B-Lymphocyte	LABEL=Cell
Postgerminal Center Marginal Zone B-Lymphocyte	LABEL=Cell
Bone Marrow Stem Cell Committed to the Basophil Lineage	LABEL=Cell
Bone Marrow Stem Cell Committed to the Megakaryocytic Lineage	LABEL=Cell
Bone Marrow-Homing Plasma Cell	LABEL=Cell
Bone Marrow Stem Cell with Potential to Differentiate to Granulocytic Lineage	LABEL=Cell
Adenohypophysial Cell	LABEL=Cell
Acinar Salivary Gland System	LABEL=Tissue
Salivary Gland Tissue	LABEL=Tissue
Alveolar Cell Type I	LABEL=Cell
Alveolar Cell Type II	LABEL=Cell
Alveolar Duct	LABEL=Tissue
Alveolar Sac	LABEL=Tissue
Semicircular Duct	LABEL=Tissue
Anal Gland	LABEL=Tissue
Anterior Mediastinal Lymph Node	LABEL=Tissue
White Matter of the Spinal Cord	LABEL=Tissue
Apocrine Sweat Gland	LABEL=Tissue
Sweat Gland	LABEL=Tissue
Arachnoid Membrane	LABEL=Tissue
Argentaffin Cell	LABEL=Cell
Enteroendocrine Cell	LABEL=Cell
Pyramid of Malpighi	LABEL=Tissue
Basaloid Cell	LABEL=Cell
Basilar Membrane of the Membranous Canal of the Cochlea	LABEL=Tissue
Basophilic Cell	LABEL=Cell
Hepatic Lobule	LABEL=Tissue
Bladder Mucosa	LABEL=Tissue
Bladder Tissue	LABEL=Tissue
Bladder Muscular Coat	LABEL=Tissue
Bladder Muscularis Mucosa	LABEL=Tissue
Muscularis Mucosa	LABEL=Tissue
Bladder Lamina Propria	LABEL=Tissue
Bladder Serosal Surface	LABEL=Tissue
Bladder Urothelial Cell	LABEL=Cell
Urothelial Cell	LABEL=Cell
Bladder Urothelium	LABEL=Tissue
Bowman's Membrane	LABEL=Tissue
Bronchial Lymph Node	LABEL=Tissue
Brush Cell	LABEL=Cell
Buccal Salivary Gland	LABEL=Tissue
Minor Salivary Gland	LABEL=Tissue
Canalis Radicis Dentis	LABEL=Tissue
Odontogenic Tissue	LABEL=Tissue
Cartilage Matrix	LABEL=Tissue
Cementoblast	LABEL=Cell
Cementocyte	LABEL=Cell
Cementum	LABEL=Tissue
Classic Lobule	LABEL=Tissue
Central Zone of the Prostatic Parenchyma	LABEL=Tissue
Ceruminous Gland	LABEL=Tissue
Cervical Gland	LABEL=Tissue
Chief Cell of the Stomach	LABEL=Cell
Chromophobe Cell	LABEL=Cell
Ciliary Epithelium	LABEL=Tissue
Ciliated Bronchial Epithelial Cell	LABEL=Cell
Cochlear Duct	LABEL=Tissue
Collecting Cell	LABEL=Cell
Common Hepatic Duct	LABEL=Tissue
Hepatic Duct	LABEL=Tissue
Common Thymocyte	LABEL=Cell
Stratified Columnar Epithelium	LABEL=Tissue
Connective Tissue Component of the Peripheral Nerve	LABEL=Tissue
Connective Tissue Proper	LABEL=Tissue
Cortical Cell Layer	LABEL=Tissue
Corticotroph Cell	LABEL=Cell
Cowper Gland	LABEL=Tissue
Cystic Duct	LABEL=Tissue
Decidual Cell	LABEL=Cell
Deep Cervical Lymph Node	LABEL=Tissue
Dense Connective Tissue	LABEL=Tissue
Dental Pulp	LABEL=Tissue
Dentin	LABEL=Tissue
Descemet's Membrane	LABEL=Tissue
Peripheral Epidermotropic T-Lymphocyte	LABEL=Cell
Gray Matter of the Spinal Cord	LABEL=Tissue
Duct of the Epididymis	LABEL=Tissue
Duct of Gartner	LABEL=Tissue
Duct Salivary Gland System	LABEL=Tissue
Ductus Santorini	LABEL=Tissue
Dura Mater	LABEL=Tissue
Bone Marrow Stem Cell at the Earliest Stage of Myeloid Differentiation	LABEL=Cell
Eccrine Sweat Gland	LABEL=Tissue
Efferent Duct	LABEL=Tissue
Ejaculatory Duct	LABEL=Tissue
Elastic Cartilage	LABEL=Tissue
Enamel	LABEL=Tissue
Endocrine Sex Organ	LABEL=Tissue
Endoneurium	LABEL=Tissue
Endosteal Cell	LABEL=Cell
Endothelium of the Glomerular Capillary	LABEL=Tissue
Capillary Endothelium	LABEL=Tissue
Epineurium	LABEL=Tissue
Esophageal Gland	LABEL=Tissue
Esophageal Glandular Cell	LABEL=Cell
Esophageal Mucosa	LABEL=Tissue
Esophageal Tissue	LABEL=Tissue
Esophageal Muscular Coat	LABEL=Tissue
Esophageal Muscularis Mucosa	LABEL=Tissue
Esophageal Squamous Cell	LABEL=Cell
External Elastic Membrane	LABEL=Tissue
Tunica Media	LABEL=Tissue
External Granular Layer of the Cerebral Cortex	LABEL=Tissue
Cortical Cell Layer of the Cerebral Cortex	LABEL=Tissue
External Pyramidal Cell Layer of the Cerebral Cortex	LABEL=Tissue
Extraglomerular Mesangial Cell	LABEL=Cell
Fascicle	LABEL=Tissue
Female Prepuce	LABEL=Tissue
Female Urethra	LABEL=Tissue
Fibrocartilage	LABEL=Tissue
Fibrous Astrocyte	LABEL=Cell
Follicular Ovarian Cell	LABEL=Cell
Foramen Apicis Dentis	LABEL=Tissue
Foveolar Cell	LABEL=Cell
Gonadotroph Cell	LABEL=Cell
Fusiform Cell	LABEL=Cell
Retina Layer	LABEL=Tissue
Ganglionic Layer of the Cerebral Cortex	LABEL=Tissue
Gastric Muscular Coat	LABEL=Tissue
Gastric Muscularis Mucosa	LABEL=Tissue
Gastric Serosal Surface	LABEL=Tissue
Gastric Submucosa	LABEL=Tissue
Blastemal Cell	LABEL=Cell
Germinal Epithelium	LABEL=Tissue
Gland of Krause	LABEL=Tissue
Accessory Lacrimal Gland	LABEL=Tissue
Gland of Moll	LABEL=Tissue
Gland of Wolfring	LABEL=Tissue
Glomerular Basement Membrane	LABEL=Tissue
Glomerular Mesangial Cell	LABEL=Cell
Sheath of Schwann	LABEL=Tissue
Granulosa Lutein Cell	LABEL=Cell
Ovarian Granulosa Cell	LABEL=Cell
Haversian Canal	LABEL=Tissue
Haversian System	LABEL=Tissue
Hepatic Stellate Cell	LABEL=Cell
Perisinusoidal Space	LABEL=Tissue
Hepatobiliary Tissue	LABEL=Tissue
Horizontal Cell of Cajal	LABEL=Cell
Immature B-Lymphocyte	LABEL=Cell
Immature Bone	LABEL=Tissue
Inferior Parathyroid Gland	LABEL=Tissue
Inguinal Lymph Node	LABEL=Tissue
Inner Enamel Epithelium	LABEL=Tissue
Inner Hair Cell of the Organ of the Corti	LABEL=Cell
Inner Limiting Membrane	LABEL=Tissue
Inner Nuclear Layer	LABEL=Tissue
Inner Plexiform Layer	LABEL=Tissue
Inner Supporting Cell	LABEL=Cell
Intercalated Duct	LABEL=Tissue
Interlobular Bile Duct	LABEL=Tissue
Interlobular Duct	LABEL=Tissue
Internal Elastic Membrane	LABEL=Tissue
Internal Granular Layer of the Cerebral Cortex	LABEL=Tissue
Internal Mammary Lymph Node	LABEL=Tissue
Interphase Cell	LABEL=Cell
Interstitial Cell of Cajal	LABEL=Cell
Interstitial Cell of the Pineal Gland	LABEL=Cell
Irregular Dense Connective Tissue	LABEL=Tissue
Labial Salivary Gland	LABEL=Tissue
Lactotroph Cell	LABEL=Cell
Lamella of Harvesian System	LABEL=Tissue
Lamina Propria	LABEL=Tissue
Large Cleaved Cell	LABEL=Cell
Large Intestinal Glandular Cell	LABEL=Cell
Large Intestinal Wall Tissue	LABEL=Tissue
Intestinal Mucosa	LABEL=Tissue
Large Intestinal Muscular Coat	LABEL=Tissue
Large Intestinal Muscularis Mucosa	LABEL=Tissue
Large Intestinal Serosal Surface	LABEL=Tissue
Intestinal Serosal Surface	LABEL=Tissue
Large Intestinal Submucosa	LABEL=Tissue
Centroblast	LABEL=Cell
Layer of the Ophthalmic Nerve Fibers	LABEL=Tissue
Layer of the Rods and Cones	LABEL=Tissue
Left Fallopian Tube	LABEL=Tissue
Left Hepatic Duct	LABEL=Tissue
Left Lung	LABEL=Tissue
Left Ovary	LABEL=Tissue
Lingual Salivary Gland	LABEL=Tissue
Lingual Tonsil	LABEL=Tissue
Lipoblast	LABEL=Cell
Liver Acinus	LABEL=Tissue
Loose Connective Tissue	LABEL=Tissue
Low Columnar Cell	LABEL=Cell
Lymph Node Cortex	LABEL=Tissue
Lymph Node Medullary Portion	LABEL=Tissue
Lymph Node Sinus	LABEL=Tissue
Lymph Node Trabecula	LABEL=Tissue
Lymphokine-Activated Natural Killer Cell	LABEL=Cell
Male Breast	LABEL=Tissue
Male Prepuce	LABEL=Tissue
Marginal Zone of the Lymph Node	LABEL=Tissue
Maturation-Stage Ameloblast	LABEL=Cell
Mature Bone	LABEL=Tissue
Mature Thymocyte	LABEL=Cell
Meibomian Gland	LABEL=Tissue
Sebaceous Gland	LABEL=Tissue
Membrane of Reissner	LABEL=Tissue
Meningothelial Cell	LABEL=Cell
Mesothelial Cell	LABEL=Cell
Mesothelium	LABEL=Tissue
Molecular Layer of the Cerebral Cortex	LABEL=Tissue
Monocytoid B-Lymphocyte	LABEL=Cell
Mucous Salivary Gland	LABEL=Tissue
Multiform Cell Layer of the Cerebral Cortex	LABEL=Tissue
Myoblast	LABEL=Cell
Myofibroblast	LABEL=Cell
Nasolacrimal Duct	LABEL=Tissue
Tunica Adventitia	LABEL=Tissue
Tissue	LABEL=Tissue
Osteoid	LABEL=Tissue
Outer Enamel Epithelium	LABEL=Tissue
Outer Hair Cell of the Organ of the Corti	LABEL=Cell
Outer Limiting Membrane	LABEL=Tissue
Outer Nuclear Layer	LABEL=Tissue
Outer Supporting Cell	LABEL=Cell
Ovarian Cortex	LABEL=Tissue
Ovarian Medulla	LABEL=Tissue
Endocrine Reproductive Tissue	LABEL=Tissue
Palatine Salivary Gland	LABEL=Tissue
Palatine Tonsil	LABEL=Tissue
Pancreatic Centroacinar Cell	LABEL=Cell
C-Cell	LABEL=Cell
Parathyroid Gland Chief Cell	LABEL=Cell
Parathyroid Gland Parenchymal Cell	LABEL=Cell
Parathyroid Gland Clear Cell	LABEL=Cell
Parathyroid Gland Follicle	LABEL=Tissue
Parathyroid Gland Epithelial Tissue	LABEL=Tissue
Parathyroid Gland Oxyphil Cell	LABEL=Cell
Parathyroid Gland Tissue	LABEL=Tissue
Parietal Pleura	LABEL=Tissue
Parotid Duct	LABEL=Tissue
Parotid Gland Lymph Node	LABEL=Tissue
Perforating Canal	LABEL=Tissue
Periarteriolar Lymphoid Sheath	LABEL=Tissue
Perineurium	LABEL=Tissue
Periodontium	LABEL=Tissue
Periosteal Cell	LABEL=Cell
Peripheral Zone of the Prostatic Parenchyma	LABEL=Tissue
Peritoneal Mesothelial Cell	LABEL=Cell
Periurethral Zone of the Prostatic Parenchyma	LABEL=Tissue
Pharyngeal Tonsil	LABEL=Tissue
Pia Mater	LABEL=Tissue
Pillar Cell	LABEL=Cell
Pineocyte	LABEL=Cell
Pineal Parenchyma	LABEL=Tissue
Pleural Mesothelial Cell	LABEL=Cell
Bone Marrow Stem Cell with Variable Lineage Potential	LABEL=Cell
Portal Lobule	LABEL=Tissue
Portal Triad	LABEL=Tissue
Posterior Pigment Epithelium	LABEL=Tissue
Pre-B Lymphocyte	LABEL=Cell
Pre-Thymocyte	LABEL=Cell
Primordial Germ Cell	LABEL=Cell
Prostatic Duct Tissue	LABEL=Tissue
Prostatic Glandular Cell	LABEL=Cell
Protoplasmic Astrocyte	LABEL=Cell
Pseudostratified Epithelium	LABEL=Tissue
Pyloric Gland	LABEL=Tissue
Pyramid of Ferrein	LABEL=Tissue
Regular Dense Connective Tissue	LABEL=Tissue
Renal Cell	LABEL=Cell
Renal Interstitial Cell	LABEL=Cell
Renal Interstitial Tissue	LABEL=Tissue
Renshaw Cell	LABEL=Cell
Reserve Stem Cell	LABEL=Cell
Right Fallopian Tube	LABEL=Tissue
Right Hepatic Duct	LABEL=Tissue
Right Lung	LABEL=Tissue
Right Lymphatic Duct	LABEL=Tissue
Right Ovary	LABEL=Tissue
Sebaceous Gland Duct	LABEL=Tissue
Sebaceous Gland of the Eyelash	LABEL=Tissue
Secondary Oocyte	LABEL=Cell
Secretory-Stage Ameloblast	LABEL=Cell
Seromucous Salivary Gland	LABEL=Tissue
Serosal Surface of the Liver	LABEL=Tissue
Simple Columnar Epithelium	LABEL=Tissue
Simple Cuboidal Epithelium	LABEL=Tissue
Head Skin	LABEL=Tissue
Small Intestinal Wall Tissue	LABEL=Tissue
Small Intestinal Muscular Coat	LABEL=Tissue
Small Intestinal Muscularis Mucosa	LABEL=Tissue
Small Intestinal Serosal Surface	LABEL=Tissue
Small Intestinal Submucosa	LABEL=Tissue
Somatotroph Cell	LABEL=Cell
Splenic Cord	LABEL=Tissue
Splenic Hilar Lymph Node	LABEL=Tissue
Splenic Lymphoid Follicle	LABEL=Tissue
Splenic Sinus	LABEL=Tissue
Splenic Trabecula	LABEL=Tissue
Stratified Cuboidal Epithelium	LABEL=Tissue
Sebocyte	LABEL=Cell
Striated Duct	LABEL=Tissue
Subcapsular Epithelium of the Lens	LABEL=Tissue
Lymph Node Subcapsular Sinus	LABEL=Tissue
Submandibular Duct	LABEL=Tissue
Superficial Cervical Lymph Node	LABEL=Tissue
Superior Parathyroid Gland	LABEL=Tissue
Suprachorioid Lamina	LABEL=Tissue
Sweat Gland Duct	LABEL=Tissue
Tendinocyte	LABEL=Cell
Terminal Bronchiole Epithelium	LABEL=Tissue
Bronchiole Epithelium	LABEL=Tissue
Theca Lutein Cell	LABEL=Cell
Thoracic Duct	LABEL=Tissue
Thymic Lobule	LABEL=Tissue
Thymic Trabecula	LABEL=Tissue
Thymus Cortex	LABEL=Tissue
Thymus Medulla	LABEL=Tissue
Thyroid Gland Epithelial Tissue	LABEL=Tissue
Thyrotroph Cell	LABEL=Cell
Totipotent Neuroepithelial Stem Cell	LABEL=Cell
Tracheal Epithelium	LABEL=Tissue
Transitional Zone of the Prostatic Parenchyma	LABEL=Tissue
Vascular Smooth Muscle Tissue	LABEL=Tissue
Type I Epithelial Receptor Cell	LABEL=Cell
Type II Epithelial Receptor Cell	LABEL=Cell
Unipolar Neuron	LABEL=Cell
Utriculosaccular Duct	LABEL=Tissue
Virchow Cell	LABEL=Cell
Visceral Afferent Neuron	LABEL=Cell
Visceral Efferent Neuron	LABEL=Cell
Visceral Pleura	LABEL=Tissue
Visceral Striated Muscle Tissue	LABEL=Tissue
White Adipose Tissue	LABEL=Tissue
White Matter	LABEL=Tissue
Ectocervical Squamous Cell	LABEL=Cell
Ectocervical Mucosa	LABEL=Tissue
Reserve Cell	LABEL=Cell
Trophoblastic Cell	LABEL=Cell
Intermediate Type Trophoblastic Cell	LABEL=Cell
Endometrial Stromal Cell	LABEL=Cell
Endometrioid Stromal Cell	LABEL=Cell
Mucinous Bronchial Cell	LABEL=Cell
Thyroid Gland Oxyphil Cell	LABEL=Cell
B-Prolymphocyte	LABEL=Cell
T-Prolymphocyte	LABEL=Cell
Immature T-Lymphocyte	LABEL=Cell
Endoderm Cell	LABEL=Cell
Yolk Cell	LABEL=Cell
Angioblast	LABEL=Cell
Ectoderm Cell	LABEL=Cell
Mesoderm Cell	LABEL=Cell
Neural Crest Cell	LABEL=Cell
Right Kidney	LABEL=Tissue
Left Kidney	LABEL=Tissue
Immunoblast	LABEL=Cell
B-Immunoblast	LABEL=Cell
T-Immunoblast	LABEL=Cell
Intermediate Mesoderm	LABEL=Tissue
Lateral Mesoderm	LABEL=Tissue
Mucous Connective Tissue	LABEL=Tissue
Neuroectoderm	LABEL=Tissue
Neuroepithelial Tissue	LABEL=Tissue
Paraxial Mesoderm	LABEL=Tissue
Surface Ectoderm	LABEL=Tissue
Cervix Glandular Epithelium	LABEL=Tissue
Choroid Plexus Epithelium	LABEL=Tissue
Primitive Bone Marrow Myeloid Stem Cell	LABEL=Cell
Intrahepatic Bile Duct Epithelium	LABEL=Tissue
Nerve Tissue, Neuroepithelial Tissue, and Nerve Sheaths	LABEL=Tissue
Salivary Gland Myoepithelial Cell	LABEL=Cell
Hilar Portion of the Hepatic Duct	LABEL=Tissue
Renal Pelvis Urothelium	LABEL=Tissue
Renal Pelvis Urothelial Cell	LABEL=Cell
Dermo-Epidermal Junction	LABEL=Tissue
Subependymal Tissue	LABEL=Tissue
Activated Mature Cytotoxic T-Lymphocyte	LABEL=Cell
Postgerminal Center Memory B-Lymphocyte	LABEL=Cell
Naive Pregerminal Center B-Lymphocyte	LABEL=Cell
Lymphatic Vessel Endothelium	LABEL=Tissue
Cervix Epithelium	LABEL=Tissue
Subependymal Cell	LABEL=Cell
Bone Spectrometry	LABEL=ResearchTechnique
Marginal Zone B-Lymphocyte of Nodal Type	LABEL=Cell
Marginal Zone B-Lymphocyte	LABEL=Cell
Mature Cytotoxic T-Lymphocyte	LABEL=Cell
Immature Peripheral Gamma/Delta Cell of Cytotoxic Type	LABEL=Cell
Immature Peripheral Alpha/Beta Cell of Cytotoxic Type	LABEL=Cell
Thymic B-Lymphocyte	LABEL=Cell
Postgerminal Center B-Lymphocyte	LABEL=Cell
Interdigitating Dendritic Cell	LABEL=Cell
Interfollicular Area of the Lymph Node	LABEL=Tissue
Postgerminal Center B-Lymphocyte of Unknown Differentiation Stage	LABEL=Cell
Mature B-Lymphocyte at the Germinal Center Stage of Differentiation	LABEL=Cell
Gallbladder Epithelium	LABEL=Tissue
Tonsillar Lymphoid Tissue	LABEL=Tissue
Syncytiotrophoblastic Cell	LABEL=Cell
Cytotrophoblastic Cell	LABEL=Cell
Extrahepatic Bile Duct Epithelium	LABEL=Tissue
Transformed Peripheral B-Lymphocyte	LABEL=Cell
Intrahepatic Portion of the Left Hepatic Duct	LABEL=Tissue
Intrahepatic Portion of the Right Hepatic Duct	LABEL=Tissue
Hilar Portion of the Left Hepatic Duct	LABEL=Tissue
Hilar Portion of the Right Hepatic Duct	LABEL=Tissue
T-Cell Large Granular Lymphocyte	LABEL=Cell
Nasopharynx Epithelium	LABEL=Tissue
Vaginal Epithelium	LABEL=Tissue
T-Lymphocyte with a Post-Thymic Immunophenotype	LABEL=Cell
Intraepithelial T-Lymphocyte of the Intestine	LABEL=Cell
Renal Tubule Epithelium	LABEL=Tissue
Renal Tubular Epithelial Cell	LABEL=Cell
Urachal Epithelium	LABEL=Tissue
Skene Gland	LABEL=Tissue
Gland of Littre	LABEL=Tissue
Representational Oligonucleotide Microarray Analysis	LABEL=ResearchTechnique
Vaginal Squamous Epithelium	LABEL=Tissue
Cervix Squamous Epithelium	LABEL=Tissue
Nephrogenic Blastemal Cell	LABEL=Cell
Negative Regulation of Antibody Titer	LABEL=AssociatedBiologicalProcess
Adhesion Factor Production	LABEL=AssociatedBiologicalProcess
Adhesion Factor Suppression	LABEL=AssociatedBiologicalProcess
Negative Regulation of Cell-Cell Adhesion	LABEL=AssociatedBiologicalProcess
Regulation of Platelet Aggregation Process	LABEL=AssociatedBiologicalProcess
Negative Regulation of Platelet Aggregation Process	LABEL=AssociatedBiologicalProcess
Leukocyte Apoptotic Process	LABEL=AssociatedBiologicalProcess
Lymphocyte Apoptotic Process	LABEL=AssociatedBiologicalProcess
Myeloid Cell Apoptotic Process	LABEL=AssociatedBiologicalProcess
Hemolytic Process	LABEL=AssociatedBiologicalProcess
Negative Regulation of Immune Cell Destruction	LABEL=AssociatedBiologicalProcess
Negative Regulation of Lymphocyte Apoptotic Process	LABEL=AssociatedBiologicalProcess
Negative Regulation of Myeloid Cell Apoptotic Process	LABEL=AssociatedBiologicalProcess
Negative Regulation of Hemolytic Process	LABEL=AssociatedBiologicalProcess
Metastasis Induction	LABEL=AssociatedBiologicalProcess
Positive Regulation of Meiosis	LABEL=AssociatedBiologicalProcess
Negative Regulation of Meiosis	LABEL=AssociatedBiologicalProcess
Cell Wall Alteration	LABEL=AssociatedBiologicalProcess
Cytoskeletal Synthesis Inhibition	LABEL=AssociatedBiologicalProcess
Keratinization Inhibition	LABEL=AssociatedBiologicalProcess
Chromogenic In Situ Hybridization	LABEL=ResearchTechnique
Bone Marrow Stem Cell with Predominant Neutrophil Differentiation	LABEL=Cell
Ciliated Respiratory Mucosa	LABEL=Tissue
Eosinophil Precursor Cell	LABEL=Cell
DNA Resequencing	LABEL=ResearchTechnique
Perineural Tissue	LABEL=Tissue
Perineurial Cell	LABEL=Cell
Negative Regulation of Cytolytic Process	LABEL=AssociatedBiologicalProcess
Bone Marrow Stem Cell with Potential to Differentiate to Granulocytic and Monocytic Lineages	LABEL=Cell
Bone Marrow Stem Cell with Some Commitment to Monocytic Differentiation	LABEL=Cell
Caspase-Independent Apoptosis	LABEL=AssociatedBiologicalProcess
Mesonephric Remnants	LABEL=Tissue
Odontogenic Epithelium	LABEL=Tissue
Multipotent Bone Marrow Stem Cell with Wide Myeloid Potential	LABEL=Cell
Primitive Stem Cell with Some Degree of Commitment to the Erythroid Lineage	LABEL=Cell
Bone Marrow Stem Cell with Potential for Megakaryocytic and Erythroid Differentiation	LABEL=Cell
Germinative Follicular Epithelium	LABEL=Tissue
Eccrine Cell	LABEL=Cell
Apocrine Cell	LABEL=Cell
Adult Stem Cell	LABEL=Cell
Epithelial Stem Cell	LABEL=Cell
Umbilical Cord Blood Stem Cell	LABEL=Cell
Wolffian Duct Cell	LABEL=Cell
Bile Duct Tissue	LABEL=Tissue
Experimental Method	LABEL=ResearchTechnique
Ovarian Surface Epithelium	LABEL=Tissue
Precursor of Plasmacytoid Dendritic Cell	LABEL=Cell
Activated Mature Gamma/Delta T-Lymphocyte with a Cytotoxic Phenotype	LABEL=Cell
Pulmonary Neuroendocrine Cell	LABEL=Cell
Perivascular Epithelioid Cell	LABEL=Cell
EBV-Transformed Late Germinal Center/Post-Germinal Center B-Lymphocyte	LABEL=Cell
EBV-Transformed Mature B-Lymphocyte	LABEL=Cell
Thymic Medullary Epithelial Cell	LABEL=Cell
Thymic Epithelial Cell Capable of Differentiating Towards Both Cortical and Medullary Cell Type	LABEL=Cell
Thymic Epithelial Cell Capable of Differentiating Towards Cortical Cell Type	LABEL=Cell
Thymic Epithelial Stem Cell	LABEL=Cell
Totipotent Primordial Germ Cell	LABEL=Cell
Pluripotent Primordial Germ Cell	LABEL=Cell
Pellet Formation	LABEL=ResearchTechnique
Anoikis	LABEL=AssociatedBiologicalProcess
Piloid Astrocyte	LABEL=Cell
Pituicyte	LABEL=Cell
Precursor Adenohypophysial Cell	LABEL=Cell
Metastatic Inhibitory Effect	LABEL=AssociatedBiologicalProcess
Left Breast	LABEL=Tissue
Right Breast	LABEL=Tissue
Splenic Marginal Zone	LABEL=Tissue
Matrix-Assisted Laser Desorption Ionization Mass Spectrometry	LABEL=ResearchTechnique
Collision-Induced Dissociation	LABEL=ResearchTechnique
Absorbance at 260nm	LABEL=ResearchTechnique
Absorbance at 280nm	LABEL=ResearchTechnique
Tongue Epithelium	LABEL=Tissue
Adrenal Cortical Cell	LABEL=Cell
Laryngeal Epithelium	LABEL=Tissue
Remnants of the Notochord	LABEL=Tissue
Cell	LABEL=Cell
Respiratory Bronchiole Epithelium	LABEL=Tissue
Cortical Cell Layer of the Cerebellum	LABEL=Tissue
Granular Layer of the Cerebellum	LABEL=Tissue
Molecular Layer of the Cerebellum	LABEL=Tissue
Internal Granular Layer of the Cerebellum	LABEL=Tissue
Aorta Endothelium	LABEL=Tissue
Aorta Smooth Muscle Tissue	LABEL=Tissue
Arteriole Endothelium	LABEL=Tissue
Arteriole Smooth Muscle Tissue	LABEL=Tissue
Artery Endothelium	LABEL=Tissue
Artery Smooth Muscle Tissue	LABEL=Tissue
Bronchus Basement Membrane	LABEL=Tissue
Bronchus Connective Tissue	LABEL=Tissue
Bronchus Elastic Tissue	LABEL=Tissue
Bronchus Lamina Propria	LABEL=Tissue
Bronchus Smooth Muscle Tissue	LABEL=Tissue
Bronchus Submucosa	LABEL=Tissue
Cerebellum White Matter	LABEL=Tissue
Brain White Matter	LABEL=Tissue
Efferent Ductule Epithelium	LABEL=Tissue
Esophageal Lamina Propria	LABEL=Tissue
Digestive System Lamina Propria	LABEL=Tissue
Esophageal Serosal Surface	LABEL=Tissue
Eyelid Subcutaneous Connective Tissue	LABEL=Tissue
Gallbladder Lamina Propria	LABEL=Tissue
Gallbladder Serosal Surface	LABEL=Tissue
Choroid Plexus Epithelium of the Fourth Ventricle	LABEL=Tissue
Fourth Ventricle Ependyma	LABEL=Tissue
Gingival Epithelium	LABEL=Tissue
Oral Cavity Epithelium	LABEL=Tissue
Laryngeal Mucous Salivary Gland	LABEL=Tissue
Laryngeal Connective Tissue	LABEL=Tissue
Laryngeal Mucosa	LABEL=Tissue
Choroid Plexus Epithelium of the Lateral Ventricle	LABEL=Tissue
Lateral Ventricle Ependyma	LABEL=Tissue
Left Lung Alveolar Duct	LABEL=Tissue
Lymphatic Vessel Smooth Muscle Tissue	LABEL=Tissue
Nasal Cavity Epithelium	LABEL=Tissue
Nasal Cavity Respiratory Epithelium	LABEL=Tissue
Oropharynx Epithelium	LABEL=Tissue
Intercalated Duct of the Salivary Gland System	LABEL=Tissue
Intercalated Duct of the Pancreas	LABEL=Tissue
Pancreatic Acinus	LABEL=Tissue
Penis Erectile Tissue	LABEL=Tissue
Prepuce Epithelium	LABEL=Tissue
Renal Tubule Basement Membrane	LABEL=Tissue
Right Lung Alveolar Duct	LABEL=Tissue
Seminal Vesicle Epithelium	LABEL=Tissue
Seminiferous Epithelium	LABEL=Tissue
Small Intestinal Lamina Propria	LABEL=Tissue
Large Intestinal Lamina Propria	LABEL=Tissue
Tongue Skeletal Muscle Tissue	LABEL=Tissue
Trachea Basement Membrane	LABEL=Tissue
Trachea Lamina Propria	LABEL=Tissue
Trachea Smooth Muscle Tissue	LABEL=Tissue
Trachea Submucosa	LABEL=Tissue
Tympanic Epithelium	LABEL=Tissue
Urethra Epithelium	LABEL=Tissue
Urethra Urothelium	LABEL=Tissue
Uterus Serosal Surface	LABEL=Tissue
Vas Deferens Epithelium	LABEL=Tissue
Vein Endothelium	LABEL=Tissue
Vena Cava Endothelium	LABEL=Tissue
Venule Endothelium	LABEL=Tissue
Venous System Endothelium	LABEL=Tissue
Venous System Smooth Muscle Tissue	LABEL=Tissue
Left Adrenal Gland	LABEL=Tissue
Left Testis	LABEL=Tissue
Left Ureter	LABEL=Tissue
Right Adrenal Gland	LABEL=Tissue
Right Testis	LABEL=Tissue
Right Ureter	LABEL=Tissue
Arterial System Endothelium	LABEL=Tissue
Arterial System Smooth Muscle Tissue	LABEL=Tissue
Brain Arachnoid Membrane	LABEL=Tissue
Brain Dura Mater	LABEL=Tissue
Brain Pia Mater	LABEL=Tissue
Alveolar Septum	LABEL=Tissue
Ear Skin	LABEL=Tissue
Eyelid Connective Tissue	LABEL=Tissue
Gallbladder Smooth Muscle Tissue	LABEL=Tissue
Lymph Node Lymphoid Follicle	LABEL=Tissue
Oropharyngeal Lymphoid Tissue	LABEL=Tissue
Peyer Patch Lymphoid Follicle	LABEL=Tissue
Peyer Patch Germinal Center	LABEL=Tissue
Lymph Node Germinal Center	LABEL=Tissue
Splenic Germinal Center	LABEL=Tissue
Splenic Marginal Sinus	LABEL=Tissue
Spinal Cord Arachnoid Membrane	LABEL=Tissue
Spinal Cord Dura Mater	LABEL=Tissue
Spinal Cord Pia Mater	LABEL=Tissue
Myopericyte	LABEL=Cell
Mechanism of Cell Death	LABEL=AssociatedBiologicalProcess
Cell Transit Process	LABEL=AssociatedBiologicalProcess
Immunoelectrophoresis	LABEL=ResearchTechnique
Oncotype DX Breast Cancer Assay	LABEL=ResearchTechnique
Cortical Bone	LABEL=Tissue
Eyelid Skin	LABEL=Tissue
Foot Digit Skin	LABEL=Tissue
Foot Skin	LABEL=Tissue
Hand Digit Skin	LABEL=Tissue
Hand Skin	LABEL=Tissue
Leg Skin	LABEL=Tissue
Ankle Skin	LABEL=Tissue
Wrist Skin	LABEL=Tissue
Elbow Skin	LABEL=Tissue
Neck Skin	LABEL=Tissue
Abdominal Skin	LABEL=Tissue
Popliteal Lymph Node	LABEL=Tissue
Isotope-Coded Affinity Tag Protein Analysis	LABEL=ResearchTechnique
Protonation	LABEL=ResearchTechnique
Sedimentation	LABEL=ResearchTechnique
Lower Gingiva	LABEL=Tissue
Upper Gingiva	LABEL=Tissue
Paranasal Sinus Epithelium	LABEL=Tissue
Normalized Quotient	LABEL=ResearchTechnique
Passage	LABEL=ResearchTechnique
Flexural Skin	LABEL=Tissue
Pluripotent Bronchial Precursor Cell	LABEL=Cell
Anal Mucosa	LABEL=Tissue
Distal 1/3 of the Common Bile Duct	LABEL=Tissue
Distal Common Bile Duct	LABEL=Tissue
Basal Cell of the Squamous Epithelium	LABEL=Cell
Odontogenic Ectomesenchyme	LABEL=Tissue
Terminal Duct Cell	LABEL=Cell
Nanoparticle Application	LABEL=ResearchTechnique
Clinical Nanoparticle Application	LABEL=ResearchTechnique
Nanoparticle-Mediated Drug Delivery	LABEL=ResearchTechnique
Non-Clinical Nanoparticle Application	LABEL=ResearchTechnique
Nanofabrication	LABEL=ResearchTechnique
Nanoimprinting	LABEL=ResearchTechnique
Nanolithography	LABEL=ResearchTechnique
Nanoparticle Characterization	LABEL=ResearchTechnique
Nanotechnology Techniques	LABEL=ResearchTechnique
Optical Trap	LABEL=ResearchTechnique
Optical Tweezers	LABEL=ResearchTechnique
Field Flow Fractionation	LABEL=ResearchTechnique
Fluorimetry	LABEL=ResearchTechnique
Light Scattering	LABEL=ResearchTechnique
Multi-Angle Laser Light Scattering	LABEL=ResearchTechnique
Static Light Scattering	LABEL=ResearchTechnique
Glow Discharge Mass Spectrometry	LABEL=ResearchTechnique
Inductively-Coupled Plasma Mass Spectrometry	LABEL=ResearchTechnique
Photon Correlation Spectroscopy	LABEL=ResearchTechnique
Nanoparticle Chemical Characterization	LABEL=ResearchTechnique
Nanoparticle Functionality	LABEL=ResearchTechnique
Nanoparticle Physical Characterization	LABEL=ResearchTechnique
Micellar Template-Mediated Nanoparticle Synthesis	LABEL=ResearchTechnique
Bioluminescence	LABEL=AssociatedBiologicalProcess
Proteomic Profiling	LABEL=ResearchTechnique
Surface-Enhanced Laser Desorption/Ionization-Time of Flight Mass Spectrometry	LABEL=ResearchTechnique
Mutation Carrier Screening	LABEL=ResearchTechnique
Chromosomal Translocation Analysis	LABEL=ResearchTechnique
Clonality Analysis	LABEL=ResearchTechnique
DNA Stability Analysis	LABEL=ResearchTechnique
Loss of Heterozygosity Analysis	LABEL=ResearchTechnique
Polymorphic Microsatellite Marker Analysis	LABEL=ResearchTechnique
Infraclavicular Lymph Node	LABEL=Tissue
Colony-Forming Unit-Granulocyte Macrophage Assay	LABEL=ResearchTechnique
Knee Skin	LABEL=Tissue
Celiac Lymph Node	LABEL=Tissue
Synchrotron X-Ray Diffraction	LABEL=ResearchTechnique
Labial Mucosa	LABEL=Tissue
Stroma	LABEL=Tissue
Pharmacogenetic Test	LABEL=ResearchTechnique
Pharmacogenomic Test	LABEL=ResearchTechnique
Linear Amplification Technique	LABEL=ResearchTechnique
Tryptic Digestion	LABEL=ResearchTechnique
Differential In-Gel Electrophoresis	LABEL=ResearchTechnique
Mononucleated Blood Cell	LABEL=Cell
Nucleated Red Blood Cell	LABEL=Cell
Nucleated Blood Cell	LABEL=Cell
Waldeyer's Tonsillar Ring	LABEL=Tissue
Radioisotopic Labeling	LABEL=ResearchTechnique
CDR3 Spectratyping	LABEL=ResearchTechnique
Parenchyma	LABEL=Tissue
Hepatitis A Viral Load PCR Measurement	LABEL=ResearchTechnique
Hepatitis B Viral Load PCR Measurement	LABEL=ResearchTechnique
Hepatitis C Viral Load PCR Measurement	LABEL=ResearchTechnique
HIV Viral Load PCR Measurement	LABEL=ResearchTechnique
Gene Knockdown	LABEL=ResearchTechnique
Muscle Layer	LABEL=Tissue
Mobilized Peripheral Blood Stem Cell	LABEL=Cell
Circumanal Gland	LABEL=Tissue
Hepatic Lymph Node	LABEL=Tissue
Mesenteric Lymph Node	LABEL=Tissue
Pancreatic Lymph Node	LABEL=Tissue
Paraaortic Lymph Node	LABEL=Tissue
Peritoneal Lymph Node	LABEL=Tissue
Portal Lymph Node	LABEL=Tissue
Renal Lymph Node	LABEL=Tissue
Sacral Lymph Node	LABEL=Tissue
Retrosacral Lymph Node	LABEL=Tissue
Retropharyngeal Lymph Node	LABEL=Tissue
Submandibular Lymph Node	LABEL=Tissue
Tracheobronchial Lymph Node	LABEL=Tissue
Intercostal Lymph Node	LABEL=Tissue
Bone Marrow, Femur	LABEL=Tissue
Bone Marrow, Humerus	LABEL=Tissue
Bone Marrow, Rib	LABEL=Tissue
Bone Marrow, Scapula	LABEL=Tissue
Bone Marrow, Sternum	LABEL=Tissue
Bone Marrow, Tibia	LABEL=Tissue
Bone Marrow, Vertebral	LABEL=Tissue
Electrophoretic Light Scattering	LABEL=ResearchTechnique
Energy Dispersive Spectroscopy	LABEL=ResearchTechnique
Laser Doppler Velocimetry-Phase Analysis Light Scattering	LABEL=ResearchTechnique
X-Ray Photoelectron Spectroscopy	LABEL=ResearchTechnique
Powder Diffraction	LABEL=ResearchTechnique
Electron Microprobe Analysis	LABEL=ResearchTechnique
Gas Sorption	LABEL=ResearchTechnique
Excision Repair Cross-Complementing 1 Messenger RNA Expression Measurement	LABEL=ResearchTechnique
Ribonucleotide Reductase Messenger RNA Expression Measurement	LABEL=ResearchTechnique
MYCN Messenger RNA Expression Measurement	LABEL=ResearchTechnique
KRAS Mutation Analysis	LABEL=ResearchTechnique
Chromosome 5q31.1 Deletion Measurement	LABEL=ResearchTechnique
Chromosome 5q31-33 Deletion Measurement	LABEL=ResearchTechnique
t(14;18) Status Analysis	LABEL=ResearchTechnique
BRAF V600E Mutation Analysis	LABEL=ResearchTechnique
Choristoma	LABEL=Tissue
Fast Protein Liquid Chromatography	LABEL=ResearchTechnique
BRCA1 Mutation Analysis	LABEL=ResearchTechnique
BRCA2 Mutation Analysis	LABEL=ResearchTechnique
Left Ear	LABEL=Tissue
Right Ear	LABEL=Tissue
Sonication	LABEL=ResearchTechnique
Immortalization	LABEL=ResearchTechnique
Gubernaculum Testis	LABEL=Tissue
Bone Trabeculae	LABEL=Tissue
Superficial Myometrium	LABEL=Tissue
Dermal Papilla	LABEL=Tissue
Crypt Epithelium	LABEL=Tissue
MammaPrint	LABEL=ResearchTechnique
Melanoblast	LABEL=Cell
Atomic Absorption Spectroscopy	LABEL=ResearchTechnique
Infrared Spectrometry	LABEL=ResearchTechnique
Optical Density Measurement	LABEL=ResearchTechnique
X-Ray Fluorescence Spectrometry	LABEL=ResearchTechnique
Mycobacterial Interspersed Repetitive Unit Typing	LABEL=ResearchTechnique
Spacer Oligonucleotide Typing	LABEL=ResearchTechnique
In Situ Hybridization Analysis of HPV 16 DNA Sequences	LABEL=ResearchTechnique
Obturator Lymph Node	LABEL=Tissue
Internal Iliac Lymph Node	LABEL=Tissue
External Iliac Lymph Node	LABEL=Tissue
Scalene Lymph Node	LABEL=Tissue
Brachial Lymph Node	LABEL=Tissue
Gastric Lymph Node	LABEL=Tissue
Sublingual Lymph Node	LABEL=Tissue
BRAF V600K Mutation Analysis	LABEL=ResearchTechnique
Oropharyngeal Tissue	LABEL=Tissue
Strand Displacement Amplification	LABEL=ResearchTechnique
Cytokine Panel 12	LABEL=ResearchTechnique
Multi-Analyte Fluorescent Detection	LABEL=ResearchTechnique
Cystic Fibrosis Carrier Screening	LABEL=ResearchTechnique
Genetic Screening	LABEL=ResearchTechnique
Montgomery Tubercle	LABEL=Tissue
Whole Genome Association Study	LABEL=ResearchTechnique
Nonspecific Immune Cell	LABEL=Cell
Heteroduplex Analysis	LABEL=ResearchTechnique
Exocrine Pancreas Cell	LABEL=Cell
DNA Gene-expression Microarray	LABEL=ResearchTechnique
Glycan Analysis	LABEL=ResearchTechnique
Cross-Talk	LABEL=AssociatedBiologicalProcess
Presymptomatic Testing	LABEL=ResearchTechnique
Optical Spectroscopy	LABEL=ResearchTechnique
Genomic Profile	LABEL=ResearchTechnique
Papillary-Reticular Dermal Interface	LABEL=Tissue
Subserosa	LABEL=Tissue
Nodular Parenchymal Tissue	LABEL=Tissue
Reticular Dermis	LABEL=Tissue
Papillary Dermis	LABEL=Tissue
Mediastinal Pleura	LABEL=Tissue
Colorimetric Cell Viability Assay	LABEL=ResearchTechnique
Rapid Screening Method for Alpha Thalassemia	LABEL=ResearchTechnique
Deimmunization	LABEL=ResearchTechnique
DNA-Directed RNA Interference	LABEL=ResearchTechnique
Endocervical Glandular Epithelium	LABEL=Tissue
Intrathyroidal Parathyroid	LABEL=Tissue
Mononucleotide Marker Panel	LABEL=ResearchTechnique
Mononucleotide and Dinucleotide Marker Panel	LABEL=ResearchTechnique
Single Cell Gel Electrophoresis	LABEL=ResearchTechnique
Intrahepatic Large Bile Duct	LABEL=Tissue
Laser Cryo Enrichment	LABEL=ResearchTechnique
CD4 Positive Memory T-Lymphocyte	LABEL=Cell
CD4 Positive Naive T-Lymphocyte	LABEL=Cell
Epitrochlear Lymph Node	LABEL=Tissue
Femoral Lymph Node	LABEL=Tissue
Pulmonary Hilar Lymph Node	LABEL=Tissue
Occipital Lymph Node	LABEL=Tissue
Retroperitoneal Lymph Node	LABEL=Tissue
Pyrosequencing	LABEL=ResearchTechnique
COLD-PCR	LABEL=ResearchTechnique
Peptide Nucleic Acid Clamping	LABEL=ResearchTechnique
Isotope Dilution Mass Spectrometry	LABEL=ResearchTechnique
