Adipogenesis	LABEL=AssociatedBiologicalProcess
Adsorption	LABEL=MaterialProcessing
Adverse Effects	LABEL=EffectOnBiologicalSystem
Aligned	LABEL=ArchitecturalOrganization
Alloy	LABEL=Biomaterial
Angiogenesis	LABEL=AssociatedBiologicalProcess
Architectural Organization	LABEL=ManufacturedObjectFeatures
Arthroplasty	LABEL=MedicalApplication
Artificial Organs	LABEL=MedicalApplication
Associated Biological Process	LABEL=Associated Biological Process	
Bi-layered	LABEL=ArchitecturalOrganization
Bilayer	LABEL=ArchitecturalOrganization
Bilayered	LABEL=ArchitecturalOrganization
Bioactive Ligand	LABEL=Bioactive Ligand	
Bioceramic	LABEL=Biomaterial
Biocompatibility	LABEL=EffectOnBiologicalSystem
Biocomposite	LABEL=OtherFeatures
Biodegradability	LABEL=DegradationFeatures
Biodegradation	LABEL=DegradationFeatures
Biofabrication	LABEL=MaterialProcessing
Biofunctionalization	LABEL=MaterialProcessing
Bioinertness	LABEL=EffectOnBiologicalSystem
Biomaterial	LABEL=Biomaterial	
Biomineralization	LABEL=AssociatedBiologicalProcess
Biopolymer	LABEL=Biomaterial
Blend	LABEL=Biomaterial
Braiding	LABEL=MaterialProcessing
Cap Coating	LABEL=MaterialProcessing
Capsule	LABEL=Structure
Cell Adhesion	LABEL=AssociatedBiologicalProcess
Cell Attachment	LABEL=AssociatedBiologicalProcess
Cell Delivery	LABEL=MedicalApplication
Cell Differentiation	LABEL=AssociatedBiologicalProcess
Cell Infiltration	LABEL=AssociatedBiologicalProcess
Cell Proliferation	LABEL=AssociatedBiologicalProcess
Cell Sheet	LABEL=ManufacturedObjectComponent
Cell Spreading	LABEL=AssociatedBiologicalProcess
Cell Viability	LABEL=AssociatedBiologicalProcess
Ceramic	LABEL=Biomaterial
Chondrogenic Differentiation	LABEL=AssociatedBiologicalProcess
Circular	LABEL=Shape
Coat	LABEL=ManufacturedObjectComponent
Coating	LABEL=MaterialProcessing
Collagen Secretion	LABEL=AssociatedBiologicalProcess
Colloid	LABEL=Structure
Composite	LABEL=OtherFeatures
Compressive Modulus	LABEL=MechanicalProperty
Conditioning	LABEL=MaterialProcessing
Conductivity	LABEL=PhysicalProperty
Copolymer	LABEL=Biomaterial
Core	LABEL=ManufacturedObjectComponent
Crosslinking	LABEL=MaterialProcessing
Cryogel	LABEL=Structure
Cryomilling	LABEL=MaterialProcessing
Crystallinity	LABEL=PhysicalProperty
Cube	LABEL=Shape
Cylinder	LABEL=Shape
Cylindrical	LABEL=Shape
Cytocompatibility	LABEL=EffectOnBiologicalSystem
Cytotoxicity	LABEL=EffectOnBiologicalSystem
Decellularization	LABEL=MaterialProcessing
Decellularized Matrix	LABEL=Biomaterial
Deformation	LABEL=MechanicalProperty
Degradability	LABEL=DegradationFeatures
Degradation Features	LABEL=ManufacturedObjectFeatures
Degradation Rate	LABEL=DegradationFeatures
Deposition	LABEL=MaterialProcessing
Disk	LABEL=Shape
Drug Delivery	LABEL=MedicalApplication
Effect On Biological System	LABEL=Effect On Biological System	
Electrospinning	LABEL=MaterialProcessing
Electrospraying	LABEL=MaterialProcessing
Encapsulation	LABEL=MedicalApplication
Endothelial Differentiation	LABEL=AssociatedBiologicalProcess
Endothelialization	LABEL=AssociatedBiologicalProcess
Engraftment	LABEL=AssociatedBiologicalProcess
Epithelialization	LABEL=AssociatedBiologicalProcess
Etching	LABEL=MaterialProcessing
Experimental_scaffold	LABEL=ManufacturedObject
Extrusion	LABEL=MaterialProcessing
Fiber	LABEL=Structure
Film	LABEL=Structure
Flexibility	LABEL=MechanicalProperty
Foam	LABEL=Structure
Foaming	LABEL=MaterialProcessing
Functionalization	LABEL=MaterialProcessing
Gel	LABEL=Structure
Gelation	LABEL=MaterialProcessing
Gelling	LABEL=MaterialProcessing
Glue	LABEL=Structure
Granule	LABEL=Structure
Groove	LABEL=StructuralDetails
Hemocompatibility	LABEL=EffectOnBiologicalSystem
Hierarchical	LABEL=ArchitecturalOrganization
Hydrogel	LABEL=Structure
Hydrophilicity	LABEL=PhysicalProperty
Immobilization	LABEL=MaterialProcessing
Immunomodulatory	LABEL=EffectOnBiologicalSystem
Impregnating	LABEL=MaterialProcessing
Knitting	LABEL=MaterialProcessing
Lattice	LABEL=Structure
Layer	LABEL=ManufacturedObjectComponent
Layered	LABEL=ArchitecturalOrganization
Macropore	LABEL=StructuralDetails
Manufacture	LABEL=MaterialProcessing
Manufactured Object	LABEL=Manufactured Object	
Manufactured Object Component	LABEL=Manufactured Object Component	
Manufactured Object Features	LABEL=Manufactured Object Features	
Mat	LABEL=Structure
Material Processing	LABEL=Material Processing	
Matrice	LABEL=Structure
Matrix Deposition	LABEL=AssociatedBiologicalProcess
Matrix Synthesis	LABEL=AssociatedBiologicalProcess
Mechanical Property	LABEL=ManufacturedObjectFeatures
Medical Application	LABEL=Medical Application	
Medical_device	LABEL=ManufacturedObject
Membrane	LABEL=Structure
Mesh	LABEL=Structure
Metal	LABEL=Biomaterial
Microbead	LABEL=Structure
Microcarrier	LABEL=MedicalApplication
Microfiber	LABEL=Structure
Microgel	LABEL=Structure
Microparticle	LABEL=Structure
Microsphere	LABEL=Structure
Multi-layered	LABEL=ArchitecturalOrganization
Multilayer	LABEL=ArchitecturalOrganization
Multilayered	LABEL=ArchitecturalOrganization
Multilineage Differentiation	LABEL=AssociatedBiologicalProcess
Myogenic Differentiation	LABEL=AssociatedBiologicalProcess
Nanobioglass	LABEL=Biomaterial
Nanocoating	LABEL=MaterialProcessing
Nanocomposite	LABEL=Structure
Nanocrystal	LABEL=Structure
Nanoencapsulation	LABEL=MedicalApplication
Nanofibre	LABEL=Structure
Nanohydroxyapetite	LABEL=Biomaterial
Nanoparticle	LABEL=Structure
Nanorod	LABEL=Shape
Nanoroughness	LABEL=PhysicalProperty
Nanosphere	LABEL=Shape
Nanotopography	LABEL=PhysicalProperty
Nanotube	LABEL=Structure
Nanotubular	LABEL=Tubular
Nanowire	LABEL=Structure
Neotissue	LABEL=MedicalApplication
Neovascularization	LABEL=AssociatedBiologicalProcess
Network	LABEL=Structure
Nodule Formation	LABEL=AssociatedBiologicalProcess
Orientation	LABEL=PhysicalProperty
Oriented	LABEL=ArchitecturalOrganization
Osteoconductivity	LABEL=AssociatedBiologicalProcess
Osteogenic Differentiation	LABEL=AssociatedBiologicalProcess
Osteoinduction	LABEL=AssociatedBiologicalProcess
Osteointegration	LABEL=AssociatedBiologicalProcess
Other Features	LABEL=ManufacturedObjectFeatures
Particle	LABEL=Structure
Perforation	LABEL=MaterialProcessing
Photocrosslinking	LABEL=MaterialProcessing
Physical Property	LABEL=ManufacturedObjectFeatures
Plasma Treatment	LABEL=MaterialProcessing
Polishing	LABEL=MaterialProcessing
Polymer	LABEL=Biomaterial
Polymerization	LABEL=MaterialProcessing
Pore	LABEL=StructuralDetails
Pore Size	LABEL=PhysicalProperty
Porosity	LABEL=PhysicalProperty
Precoating	LABEL=MaterialProcessing
Preconditioning	LABEL=MaterialProcessing
Printing	LABEL=MaterialProcessing
Regeneration	LABEL=MedicalApplication
Reinforcement	LABEL=MaterialProcessing
Resurfacing	LABEL=MaterialProcessing
Revascularization	LABEL=AssociatedBiologicalProcess
Rod	LABEL=Shape
Roughening	LABEL=MaterialProcessing
Sandblasting	LABEL=MaterialProcessing
Shape	LABEL=ManufacturedObjectFeatures
Sheet	LABEL=Structure
Shell	LABEL=ManufacturedObjectComponent
Shell-core	LABEL=Structure
Sintering	LABEL=MaterialProcessing
Sol-gel	LABEL=MaterialProcessing
Sphere	LABEL=Shape
Spheroid	LABEL=Shape
Spiral	LABEL=ArchitecturalOrganization
Sponge	LABEL=Structure
Sputtering	LABEL=MaterialProcessing
Stiffness	LABEL=MechanicalProperty
Structural Details	LABEL=ManufacturedObjectFeatures
Structure	LABEL=ManufacturedObjectFeatures
Surface	LABEL=ManufacturedObjectComponent
Surface Functionalization	LABEL=MaterialProcessing
Surface Hydrophilicity	LABEL=PhysicalProperty
Surface Topography	LABEL=PhysicalProperty
Surgical	LABEL=MedicalApplication
Tenogenic Differentiation	LABEL=AssociatedBiologicalProcess
Textile	LABEL=Structure
Thermally Induced Phase Separation	LABEL=MaterialProcessing
Thermogel	LABEL=Structure
Thin Film	LABEL=Structure
Thread	LABEL=Structure
Tissue Integration	LABEL=EffectOnBiologicalSystem
Tissue Reconstruction	LABEL=MedicalApplication
Topology	LABEL=PhysicalProperty
Toughness	LABEL=MechanicalProperty
Toxicity	LABEL=EffectOnBiologicalSystem
Tripolymer	LABEL=Biomaterial
Tubular	LABEL=Shape
Unidirectional	LABEL=ArchitecturalOrganization
Vascularization	LABEL=AssociatedBiologicalProcess
Vocal Fold Augmentation	LABEL=MedicalApplication
Weaving	LABEL=MaterialProcessing
Wettability	LABEL=PhysicalProperty
Wire	LABEL=Structure
Wound Dressing	LABEL=MedicalApplication
Wrapped	LABEL=ArchitecturalOrganization
bioprinting	LABEL=MaterialProcessing
osteogenicity	LABEL=EffectOnBiologicalSystem
3 D Printing	LABEL=MaterialProcessing
Encapsulating	LABEL=ManufacturedObjectFeatures
absorbable	LABEL=ManufacturedObjectFeatures
acellular	LABEL=ManufacturedObjectFeatures
acid_etched	LABEL=ManufacturedObjectFeatures
adsorbed	LABEL=ManufacturedObjectFeatures
antibacterial	LABEL=ManufacturedObjectFeatures
antimicrobial	LABEL=ManufacturedObjectFeatures
biodegradable	LABEL=ManufacturedObjectFeatures
biofunctional	LABEL=ManufacturedObjectFeatures
bioprinted	LABEL=ManufacturedObjectFeatures
bioresorbable	LABEL=ManufacturedObjectFeatures
blended	LABEL=ManufacturedObjectFeatures
braided	LABEL=ManufacturedObjectFeatures
calcified	LABEL=ManufacturedObjectFeatures
cementogenic	LABEL=ManufacturedObjectFeatures
coated	LABEL=ManufacturedObjectFeatures
conditioned	LABEL=ManufacturedObjectFeatures
conductive	LABEL=ManufacturedObjectFeatures
crosslinked	LABEL=ManufacturedObjectFeatures
cytocompatible	LABEL=ManufacturedObjectFeatures
cytotoxic	LABEL=ManufacturedObjectFeatures
decellularized	LABEL=ManufacturedObjectFeatures
decorated	LABEL=ManufacturedObjectFeatures
degradable	LABEL=ManufacturedObjectFeatures
demineralized	LABEL=ManufacturedObjectFeatures
deproteinized	LABEL=ManufacturedObjectFeatures
doped	LABEL=ManufacturedObjectFeatures
ecm_derived	LABEL=ManufacturedObjectFeatures
elastomeric	LABEL=ManufacturedObjectFeatures
electroactive	LABEL=ManufacturedObjectFeatures
electrospun	LABEL=ManufacturedObjectFeatures
endodonic	LABEL=ManufacturedObjectFeatures
etched	LABEL=ManufacturedObjectFeatures
extruded	LABEL=ManufacturedObjectFeatures
fibrous	LABEL=ManufacturedObjectFeatures
flexible	LABEL=ManufacturedObjectFeatures
foamed	LABEL=ManufacturedObjectFeatures
funcionalized	LABEL=ManufacturedObjectFeatures
grooved	LABEL=ManufacturedObjectFeatures
has_porosity	LABEL=ManufacturedObjectFeatures
hydrophilic	LABEL=ManufacturedObjectFeatures
hydrophobic	LABEL=ManufacturedObjectFeatures
impregnated	LABEL=ManufacturedObjectFeatures
injectable	LABEL=ManufacturedObjectFeatures
interconnected_porous	LABEL=ManufacturedObjectFeatures
is_not_treated	LABEL=ManufacturedObjectFeatures
is_treated	LABEL=ManufacturedObjectFeatures
knitted	LABEL=ManufacturedObjectFeatures
macroporous	LABEL=ManufacturedObjectFeatures
mesoporous	LABEL=ManufacturedObjectFeatures
microfibrous	LABEL=ManufacturedObjectFeatures
microgrooved	LABEL=ManufacturedObjectFeatures
microporous	LABEL=ManufacturedObjectFeatures
microstructured	LABEL=ManufacturedObjectFeatures
microtextured	LABEL=ManufacturedObjectFeatures
mineralized	LABEL=ManufacturedObjectFeatures
nanocrystalline	LABEL=ManufacturedObjectFeatures
nanofibrous	LABEL=ManufacturedObjectFeatures
nanoporous	LABEL=ManufacturedObjectFeatures
nanoscale	LABEL=ManufacturedObjectFeatures
nanostructured	LABEL=ManufacturedObjectFeatures
nonwoven	LABEL=ManufacturedObjectFeatures
osteoinductive	LABEL=ManufacturedObjectFeatures
osteomimetic	LABEL=ManufacturedObjectFeatures
pegylated	LABEL=ManufacturedObjectFeatures
perforated	LABEL=ManufacturedObjectFeatures
photocrosslinkable	LABEL=ManufacturedObjectFeatures
photocrosslinked	LABEL=ManufacturedObjectFeatures
plasma_treated	LABEL=ManufacturedObjectFeatures
polished	LABEL=ManufacturedObjectFeatures
polymeric	LABEL=ManufacturedObjectFeatures
polymerized	LABEL=ManufacturedObjectFeatures
precoated	LABEL=ManufacturedObjectFeatures
preconditioned	LABEL=ManufacturedObjectFeatures
purified	LABEL=ManufacturedObjectFeatures
reinforced	LABEL=ManufacturedObjectFeatures
resorbable	LABEL=ManufacturedObjectFeatures
roughened	LABEL=ManufacturedObjectFeatures
sandblasted	LABEL=ManufacturedObjectFeatures
seeded	LABEL=ManufacturedObjectFeatures
sintered	LABEL=ManufacturedObjectFeatures
spongy	LABEL=ManufacturedObjectFeatures
synthetic	LABEL=ManufacturedObjectFeatures
thermoresponsive	LABEL=ManufacturedObjectFeatures
tissue_derived	LABEL=ManufacturedObjectFeatures
toxic	LABEL=ManufacturedObjectFeatures
transparent	LABEL=ManufacturedObjectFeatures
uncoated	LABEL=ManufacturedObjectFeatures
unmodified	LABEL=ManufacturedObjectFeatures
woven	LABEL=ManufacturedObjectFeatures
3 D_printed	LABEL=ManufacturedObjectFeatures
