somite	LABEL=Tissue
fibroblast	LABEL=Cell
ameloblast	LABEL=Cell
odontoblast	LABEL=Cell
osteoblast	LABEL=Cell
ependymal cell	LABEL=Cell
epithelial cell	LABEL=Cell
ciliated epithelial cell	LABEL=Cell
blood vessel endothelial cell	LABEL=Cell
columnar/cuboidal epithelial cell	LABEL=Cell
squamous epithelial cell	LABEL=Cell
mesothelial cell	LABEL=Cell
sensory epithelial cell	LABEL=Cell
endothelial cell	LABEL=Cell
mesenchymal stem cell	LABEL=Cell
fat cell	LABEL=Cell
osteocyte	LABEL=Cell
chondrocyte	LABEL=Cell
glandular epithelial cell	LABEL=Cell
peptic cell	LABEL=Cell
club cell	LABEL=Cell
goblet cell	LABEL=Cell
parietal cell	LABEL=Cell
enteroendocrine cell	LABEL=Cell
neuroendocrine cell	LABEL=Cell
chromaffin cell	LABEL=Cell
luteal cell	LABEL=Cell
hepatocyte	LABEL=Cell
myoepithelial cell	LABEL=Cell
auditory hair cell	LABEL=Cell
taste receptor cell	LABEL=Cell
synovial cell	LABEL=Cell
Sertoli cell	LABEL=Cell
Merkel cell	LABEL=Cell
keratinocyte	LABEL=Cell
pneumocyte	LABEL=Cell
extracellular matrix secreting cell	LABEL=Cell
reticular cell	LABEL=Cell
chief cell of parathyroid gland	LABEL=Cell
white fat cell	LABEL=Cell
brown fat cell	LABEL=Cell
granulosa cell	LABEL=Cell
type D enteroendocrine cell	LABEL=Cell
theca cell	LABEL=Cell
type G enteroendocrine cell	LABEL=Cell
angioblastic mesenchymal cell	LABEL=Cell
parafollicular cell	LABEL=Cell
prickle cell	LABEL=Cell
mesangial cell	LABEL=Cell
pinealocyte	LABEL=Cell
glomerular visceral epithelial cell	LABEL=Cell
PP cell	LABEL=Cell
stratum granulosum cell	LABEL=Cell
cardiac muscle cell	LABEL=Cell
olfactory epithelial support cell	LABEL=Cell
terminally differentiated osteoblast	LABEL=Cell
non-terminally differentiated osteoblast	LABEL=Cell
type I pneumocyte	LABEL=Cell
type II pneumocyte	LABEL=Cell
pancreatic acinar cell	LABEL=Cell
type A enteroendocrine cell	LABEL=Cell
Purkinje myocyte	LABEL=Cell
transitional myocyte	LABEL=Cell
myocardial endocrine cell	LABEL=Cell
ecto-epithelial cell	LABEL=Cell
type II cell of carotid body	LABEL=Cell
type II cell of adrenal medulla	LABEL=Cell
type I cell of adrenal medulla	LABEL=Cell
bone marrow cell	LABEL=Cell
hilus cell of ovary	LABEL=Cell
type II cell of adrenal cortex	LABEL=Cell
type III cell of adrenal cortex	LABEL=Cell
endothelial cell of lymphatic vessel	LABEL=Cell
ciliated columnar cell of tracheobronchial tree	LABEL=Cell
epithelial cell of Malassez	LABEL=Cell
basal cell of olfactory epithelium	LABEL=Cell
extraglomerular mesangial cell	LABEL=Cell
follicular cell of ovary	LABEL=Cell
basal cell of epidermis	LABEL=Cell
oxyphil cell of parathyroid gland	LABEL=Cell
intermediate epitheliocyte	LABEL=Cell
interstitial cell of pineal gland	LABEL=Cell
marrow fibroblast	LABEL=Cell
thyroid follicular cell	LABEL=Cell
epithelial cell of parathyroid gland	LABEL=Cell
type I cell of carotid body	LABEL=Cell
epithelial cell of thymus	LABEL=Cell
type-1 epithelial cell of thymus	LABEL=Cell
somatotroph	LABEL=Cell
supporting cell of vestibular epithelium	LABEL=Cell
connective tissue cell	LABEL=Cell
trabecular meshwork cell	LABEL=Cell
cardiocyte	LABEL=Cell
otic fibrocyte	LABEL=Cell
renal principal cell	LABEL=Cell
coronet cell	LABEL=Cell
lens fiber cell	LABEL=Cell
fibroblast of areolar connective tissue	LABEL=Cell
fibroblast of tunica adventitia of artery	LABEL=Cell
epicardial adipocyte	LABEL=Cell
type 1 vestibular sensory cell of epithelium of macula of utricle of membranous labyrinth	LABEL=Cell
type 1 vestibular sensory cell of epithelium of macula of saccule of membranous labyrinth	LABEL=Cell
type 2 vestibular sensory cell of epithelium of macula of utricle of membranous labyrinth	LABEL=Cell
type 2 vestibular sensory cell of epithelium of macula of saccule of membranous labyrinth	LABEL=Cell
myocyte of sinoatrial node	LABEL=Cell
myocyte of atrioventricular node	LABEL=Cell
myoepithelial cell of lactiferous gland	LABEL=Cell
chromaffin cell of adrenal gland	LABEL=Cell
adrenal cortex chromaffin cell	LABEL=Cell
cholangiocyte	LABEL=Cell
kidney interstitial fibroblast	LABEL=Cell
matrix-based tissue	LABEL=Tissue
arborizing epithelial duct system	LABEL=Tissue
epithelial plexus	LABEL=Tissue
epithelial vesicle	LABEL=Tissue
dense mesenchyme tissue	LABEL=Tissue
loose mesenchyme tissue	LABEL=Tissue
migrating mesenchyme population	LABEL=Tissue
migrating epithelium	LABEL=Tissue
connective tissue	LABEL=Tissue
skin epidermis	LABEL=Tissue
dorsal pancreatic bud	LABEL=Tissue
ventral pancreatic bud	LABEL=Tissue
lymphoid tissue	LABEL=Tissue
embryonic lymph sac	LABEL=Tissue
epithelium	LABEL=Tissue
loose connective tissue	LABEL=Tissue
granulosa cell layer	LABEL=Tissue
dentine	LABEL=Tissue
enameloid	LABEL=Tissue
mesothelium	LABEL=Tissue
tendon	LABEL=Tissue
dense regular connective tissue	LABEL=Tissue
trunk neural crest	LABEL=Tissue
neural tissue	LABEL=Tissue
macula	LABEL=Tissue
tissue	LABEL=Tissue
ureter ureteric bud	LABEL=Tissue
epithelial layer of duct	LABEL=Tissue
external ectoderm	LABEL=Tissue
unilaminar epithelium	LABEL=Tissue
embryonic tissue	LABEL=Tissue
ectoderm	LABEL=Tissue
endoderm	LABEL=Tissue
mesoderm	LABEL=Tissue
metanephric mesenchyme	LABEL=Tissue
metanephric ureteric bud	LABEL=Tissue
mesonephric tubule	LABEL=Tissue
epithelial tube	LABEL=Tissue
mesonephric epithelium	LABEL=Tissue
ureteric bud	LABEL=Tissue
epithelial sac	LABEL=Tissue
mesonephric duct	LABEL=Tissue
trophectoderm	LABEL=Tissue
dense connective tissue	LABEL=Tissue
cardiac neural crest	LABEL=Tissue
neural crest	LABEL=Tissue
vagal neural crest	LABEL=Tissue
lung connective tissue	LABEL=Tissue
lower respiratory tract connective tissue	LABEL=Tissue
thoracic segment connective tissue	LABEL=Tissue
lung mesenchyme	LABEL=Tissue
lung epithelium	LABEL=Tissue
lower respiratory tract epithelium	LABEL=Tissue
lung bud	LABEL=Tissue
epithelial bud	LABEL=Tissue
endo-epithelium	LABEL=Tissue
cell layer	LABEL=Tissue
lamina	LABEL=Tissue
blood brain barrier	LABEL=Tissue
perineurium	LABEL=Tissue
dense irregular connective tissue	LABEL=Tissue
epineurium	LABEL=Tissue
endoneurium	LABEL=Tissue
reticular tissue	LABEL=Tissue
sympathetic nerve plexus	LABEL=Tissue
theca cell layer	LABEL=Tissue
embryonic skin basal layer	LABEL=Tissue
endothelial blood brain barrier	LABEL=Tissue
endothelium	LABEL=Tissue
glial blood brain barrier	LABEL=Tissue
amniotic ectoderm	LABEL=Tissue
amniotic mesoderm	LABEL=Tissue
extensor pre-muscle mass	LABEL=Tissue
fibrous connective tissue	LABEL=Tissue
portion of cartilage tissue in tibia	LABEL=Tissue
cartilage tissue	LABEL=Tissue
lower leg connective tissue	LABEL=Tissue
pelvic appendage cartilage tissue	LABEL=Tissue
stomach glandular epithelium	LABEL=Tissue
yellow bone marrow	LABEL=Tissue
bone marrow	LABEL=Tissue
red bone marrow	LABEL=Tissue
hematopoietic tissue	LABEL=Tissue
urothelium	LABEL=Tissue
multilaminar epithelium	LABEL=Tissue
flexor pre-muscle mass	LABEL=Tissue
head somite	LABEL=Tissue
urinary bladder detrusor smooth muscle	LABEL=Tissue
urinary bladder smooth muscle	LABEL=Tissue
fibrocartilage	LABEL=Tissue
lens cortex	LABEL=Tissue
lens anterior epithelium	LABEL=Tissue
colonic epithelium	LABEL=Tissue
epithelium of large intestine	LABEL=Tissue
cartilage tissue of sternum	LABEL=Tissue
jejunal epithelium	LABEL=Tissue
epithelium of intestinal villus	LABEL=Tissue
dermal papilla	LABEL=Tissue
myoepithelium	LABEL=Tissue
atypical epithelium	LABEL=Tissue
prostate epithelium	LABEL=Tissue
simple columnar epithelium	LABEL=Tissue
meso-epithelium	LABEL=Tissue
enteric plexus	LABEL=Tissue
nerve plexus	LABEL=Tissue
autonomic nerve plexus	LABEL=Tissue
lymphoid follicle	LABEL=Tissue
simple cuboidal epithelium	LABEL=Tissue
cuboidal epithelium	LABEL=Tissue
columnar epithelium	LABEL=Tissue
simple squamous epithelium	LABEL=Tissue
squamous epithelium	LABEL=Tissue
germ layer	LABEL=Tissue
germ layer / neural crest	LABEL=Tissue
mesectoderm	LABEL=Tissue
imaginal disc	LABEL=Tissue
optic stalk	LABEL=Tissue
endocardial cushion	LABEL=Tissue
heart tube	LABEL=Tissue
corneal epithelium	LABEL=Tissue
corneal primordium	LABEL=Tissue
lens vesicle	LABEL=Tissue
bone tissue	LABEL=Tissue
humerus cartilage element	LABEL=Tissue
lateral plate mesoderm	LABEL=Tissue
femur cartilage element	LABEL=Tissue
outer epithelium	LABEL=Tissue
eponychium	LABEL=Tissue
periderm	LABEL=Tissue
adipose tissue	LABEL=Tissue
sheath of Schwann	LABEL=Tissue
yolk sac	LABEL=Tissue
extraembryonic tissue	LABEL=Tissue
mesenchyme	LABEL=Tissue
neural tube	LABEL=Tissue
ecto-epithelium	LABEL=Tissue
Malpighian tubule	LABEL=Tissue
renal tubule	LABEL=Tissue
nucleus pulposus	LABEL=Tissue
endocardium of ventricle	LABEL=Tissue
clavicle cartilage element	LABEL=Tissue
intercostal pre-muscle mass	LABEL=Tissue
pectoral girdle and thoracic body wall skeletal muscle	LABEL=Tissue
latissimus dorsi pre-muscle mass	LABEL=Tissue
serratus ventralis pre-muscle mass	LABEL=Tissue
cervical nerve plexus	LABEL=Tissue
sterno-mastoid pre-muscle mass	LABEL=Tissue
subscapularis pre-muscle mass	LABEL=Tissue
cardiac muscle tissue	LABEL=Tissue
striated muscle tissue	LABEL=Tissue
skeletal muscle tissue	LABEL=Tissue
muscle tissue	LABEL=Tissue
smooth muscle tissue	LABEL=Tissue
brachial nerve plexus	LABEL=Tissue
biliary bud	LABEL=Tissue
future common hepatic duct	LABEL=Tissue
muscularis mucosae of stomach	LABEL=Tissue
muscularis mucosa	LABEL=Tissue
stomach smooth muscle	LABEL=Tissue
muscularis mucosae of small intestine	LABEL=Tissue
muscularis mucosae of intestine	LABEL=Tissue
small intestine smooth muscle	LABEL=Tissue
Peyer's patch	LABEL=Tissue
gut-associated lymphoid tissue	LABEL=Tissue
intestinal epithelium	LABEL=Tissue
kidney capsule	LABEL=Tissue
nephron tubule	LABEL=Tissue
nephron epithelium	LABEL=Tissue
kidney mesenchyme	LABEL=Tissue
muscularis mucosae of large intestine	LABEL=Tissue
large intestine smooth muscle	LABEL=Tissue
intestine smooth muscle	LABEL=Tissue
internal anal sphincter	LABEL=Tissue
anal region smooth muscle	LABEL=Tissue
spleen lymphoid follicle	LABEL=Tissue
urothelium of ureter	LABEL=Tissue
iliac cartilage element	LABEL=Tissue
ischial cartilage element	LABEL=Tissue
pubic cartilage element	LABEL=Tissue
epithelium of stomach	LABEL=Tissue
epithelium of mucosa	LABEL=Tissue
gastrointestinal system epithelium	LABEL=Tissue
foregut epithelium	LABEL=Tissue
digestive tract epithelium	LABEL=Tissue
hepatic diverticulum	LABEL=Tissue
hepatic sinusoid	LABEL=Tissue
sinusoid	LABEL=Tissue
uriniferous tubule	LABEL=Tissue
primitive nephron	LABEL=Tissue
proximal convoluted tubule	LABEL=Tissue
renal convoluted tubule	LABEL=Tissue
renal cortex tubule	LABEL=Tissue
proximal tubule	LABEL=Tissue
proximal straight tubule	LABEL=Tissue
loop of Henle	LABEL=Tissue
region of nephron tubule	LABEL=Tissue
distal convoluted tubule	LABEL=Tissue
descending limb of loop of Henle	LABEL=Tissue
renal straight tubule	LABEL=Tissue
outer medulla outer stripe loop of Henle	LABEL=Tissue
thick ascending limb of loop of Henle	LABEL=Tissue
ascending limb of loop of Henle	LABEL=Tissue
distal tubule	LABEL=Tissue
glans clitoris	LABEL=Tissue
germinal epithelium of ovary	LABEL=Tissue
epithelium of female gonad	LABEL=Tissue
ovary sex cord	LABEL=Tissue
lumbosacral nerve plexus	LABEL=Tissue
corpus spongiosum of penis	LABEL=Tissue
testis sex cord	LABEL=Tissue
epithelium of vagina	LABEL=Tissue
oviduct epithelium	LABEL=Tissue
white adipose tissue	LABEL=Tissue
brown adipose tissue	LABEL=Tissue
1st arch pharyngeal cleft	LABEL=Tissue
auditory meatus epithelium	LABEL=Tissue
external anal sphincter	LABEL=Tissue
skeletal muscle tissue of trunk	LABEL=Tissue
anal region skeletal muscle	LABEL=Tissue
calcaneal tendon	LABEL=Tissue
jugular lymph sac	LABEL=Tissue
carpus cartilage element	LABEL=Tissue
compact bone tissue	LABEL=Tissue
lamellar bone	LABEL=Tissue
trabecular bone tissue	LABEL=Tissue
tarsus cartilage element	LABEL=Tissue
calcaneum cartilage element	LABEL=Tissue
deltoid pre-muscle mass	LABEL=Tissue
teres major pre-muscle mass	LABEL=Tissue
pectoral pre-muscle mass	LABEL=Tissue
infrapatellar fat pad	LABEL=Tissue
pharyngeal raphe	LABEL=Tissue
hypoglossal cord	LABEL=Tissue
extrinsic tongue pre-muscle mass	LABEL=Tissue
muscularis orbicularis	LABEL=Tissue
olfactory epithelium	LABEL=Tissue
pterygomandibular raphe	LABEL=Tissue
facial modiolus	LABEL=Tissue
stapedius pre-muscle condensation	LABEL=Tissue
tensor tympani pre-muscle condensation	LABEL=Tissue
skeletal muscle tissue of eye	LABEL=Tissue
extrinsic ocular pre-muscle mass	LABEL=Tissue
ciliary muscle	LABEL=Tissue
smooth muscle of eye	LABEL=Tissue
sphincter pupillae	LABEL=Tissue
iris smooth muscle	LABEL=Tissue
neurectoderm	LABEL=Tissue
dilatator pupillae	LABEL=Tissue
body-wall mesenchyme	LABEL=Tissue
basal plate metencephalon	LABEL=Tissue
sclerotome	LABEL=Tissue
sphenoid cartilage element	LABEL=Tissue
basioccipital cartilage element	LABEL=Tissue
exoccipital cartilage element	LABEL=Tissue
cranial neural crest	LABEL=Tissue
mesenchyme from rhombencephalic neural crest	LABEL=Tissue
glossopharyngeal neural crest	LABEL=Tissue
gustatory epithelium	LABEL=Tissue
early pharyngeal endoderm	LABEL=Tissue
dorsal part of pharyngeal pouch 2	LABEL=Tissue
pharyngeal tonsil	LABEL=Tissue
tonsil	LABEL=Tissue
nasal-associated lymphoid tissue	LABEL=Tissue
tonsillar ring	LABEL=Tissue
thyroid pre-cartilage condensation	LABEL=Tissue
laryngeal pre-cartilage condensation	LABEL=Tissue
arytenoid pre-cartilage condensation	LABEL=Tissue
corniculate cartilage	LABEL=Tissue
elastic cartilage tissue	LABEL=Tissue
larynx connective tissue	LABEL=Tissue
lymphomyeloid tissue	LABEL=Tissue
secondary nodular lymphoid tissue	LABEL=Tissue
germinal center	LABEL=Tissue
primary nodular lymphoid tissue	LABEL=Tissue
odontoid tissue	LABEL=Tissue
mineralized skeletal tissue	LABEL=Tissue
pre-dentine	LABEL=Tissue
enamel	LABEL=Tissue
pre-enamel	LABEL=Tissue
cementum	LABEL=Tissue
dental follicle	LABEL=Tissue
dental pulp	LABEL=Tissue
odontogenic papilla	LABEL=Tissue
periodontium	LABEL=Tissue
thyroid primordium	LABEL=Tissue
3rd arch endoderm	LABEL=Tissue
developing mesenchymal condensation	LABEL=Tissue
mesenchyme derived from head neural crest	LABEL=Tissue
uncondensed odontogenic mesenchyme	LABEL=Tissue
mammary duct	LABEL=Tissue
epithelium of mammary gland	LABEL=Tissue
optic vesicle	LABEL=Tissue
eye epithelium	LABEL=Tissue
eye mesenchyme	LABEL=Tissue
ciliary epithelium	LABEL=Tissue
pigmented layer of retina	LABEL=Tissue
vitreous body	LABEL=Tissue
head connective tissue	LABEL=Tissue
epithelium of lens	LABEL=Tissue
spinal nerve plexus	LABEL=Tissue
lacrimal gland bud	LABEL=Tissue
nasal cartilage	LABEL=Tissue
future upper lip	LABEL=Tissue
future lower lip	LABEL=Tissue
ear vesicle	LABEL=Tissue
areolar connective tissue	LABEL=Tissue
mesencephalic neural crest	LABEL=Tissue
diencephalon neural crest	LABEL=Tissue
epithelium of trachea	LABEL=Tissue
endoderm of foregut	LABEL=Tissue
epithelium of small intestine	LABEL=Tissue
mammary bud	LABEL=Tissue
endothelium of capillary	LABEL=Tissue
blood vessel endothelium	LABEL=Tissue
endothelium of arteriole	LABEL=Tissue
arterial system endothelium	LABEL=Tissue
endothelium of artery	LABEL=Tissue
endothelial tube	LABEL=Tissue
endothelium of venule	LABEL=Tissue
venous system endothelium	LABEL=Tissue
endothelium of vein	LABEL=Tissue
gingival epithelium	LABEL=Tissue
oral epithelium	LABEL=Tissue
stratified squamous epithelium	LABEL=Tissue
jaw epithelium	LABEL=Tissue
epithelium of nasopharynx	LABEL=Tissue
pharyngeal epithelium	LABEL=Tissue
upper respiratory tract epithelium	LABEL=Tissue
epithelium of oropharynx	LABEL=Tissue
epithelium of respiratory bronchiole	LABEL=Tissue
epithelium of bronchiole	LABEL=Tissue
hyaline cartilage tissue	LABEL=Tissue
terminal bronchiole epithelium	LABEL=Tissue
mucosa-associated lymphoid tissue	LABEL=Tissue
epithelium-associated lymphoid tissue	LABEL=Tissue
bronchial-associated lymphoid tissue	LABEL=Tissue
renal nerve plexus	LABEL=Tissue
epithelium of esophagus	LABEL=Tissue
epithelial tube open at both ends	LABEL=Tissue
intervillus pockets	LABEL=Tissue
corneal endothelium	LABEL=Tissue
non-mineralized cartilage tissue	LABEL=Tissue
cartilaginous condensation	LABEL=Tissue
sensory epithelium	LABEL=Tissue
nasal cavity epithelium	LABEL=Tissue
primitive olfactory epithelium	LABEL=Tissue
cardiac nerve plexus	LABEL=Tissue
pulmonary nerve plexus	LABEL=Tissue
celiac nerve plexus	LABEL=Tissue
superior hypogastric nerve plexus	LABEL=Tissue
hypogastric nerve	LABEL=Tissue
inferior hypogastric nerve plexus	LABEL=Tissue
abdomen connective tissue	LABEL=Tissue
synovial membrane of synovial joint	LABEL=Tissue
internal carotid nerve plexus	LABEL=Tissue
stratum corneum of epidermis	LABEL=Tissue
epithelium of gall bladder	LABEL=Tissue
epithelium of bronchus	LABEL=Tissue
arrector muscle of hair	LABEL=Tissue
lymphatic vessel endothelium	LABEL=Tissue
cardiovascular system endothelium	LABEL=Tissue
trunk mesenchyme	LABEL=Tissue
cardiac mesenchyme	LABEL=Tissue
mesenchyme derived from neural crest	LABEL=Tissue
conducting system of heart	LABEL=Tissue
future dermis	LABEL=Tissue
umbilicus	LABEL=Tissue
cuticle of hair	LABEL=Tissue
secondary heart field	LABEL=Tissue
primary heart field	LABEL=Tissue
spleen primordium	LABEL=Tissue
septum transversum	LABEL=Tissue
liver bud	LABEL=Tissue
artery smooth muscle tissue	LABEL=Tissue
blood vessel smooth muscle	LABEL=Tissue
arterial system smooth muscle	LABEL=Tissue
smooth muscle of esophagus	LABEL=Tissue
pronephric mesoderm	LABEL=Tissue
cardiac skeleton	LABEL=Tissue
mitral valve anulus	LABEL=Tissue
endocardial endothelium	LABEL=Tissue
alveolar sac	LABEL=Tissue
subcutaneous adipose tissue	LABEL=Tissue
manubrium sternum pre-cartilage condensation	LABEL=Tissue
sternebral bone pre-cartilage condensation	LABEL=Tissue
macula of saccule of membranous labyrinth	LABEL=Tissue
macula of utricle of membranous labyrinth	LABEL=Tissue
perichondrium	LABEL=Tissue
endolymphatic sac	LABEL=Tissue
inner ear epithelium	LABEL=Tissue
rib cartilage element	LABEL=Tissue
spinal cord neural crest	LABEL=Tissue
nail matrix	LABEL=Tissue
hyponychium	LABEL=Tissue
macula densa	LABEL=Tissue
mesangium	LABEL=Tissue
epithelium of urethra	LABEL=Tissue
notochordal plate	LABEL=Tissue
epithelium of lobar bronchus	LABEL=Tissue
epithelium of main bronchus	LABEL=Tissue
epithelium of segmental bronchus	LABEL=Tissue
neural plate	LABEL=Tissue
neural fold	LABEL=Tissue
proepicardium	LABEL=Tissue
cardiac muscle tissue of myocardium	LABEL=Tissue
conducting tissue of heart	LABEL=Tissue
sinoatrial node	LABEL=Tissue
atrioventricular node	LABEL=Tissue
cardiac muscle tissue of interatrial septum	LABEL=Tissue
atrioventricular bundle	LABEL=Tissue
cardiac muscle tissue of ventricle	LABEL=Tissue
His-Purkinje system	LABEL=Tissue
cardiac Purkinje fiber	LABEL=Tissue
inner epithelial layer of tympanic membrane	LABEL=Tissue
outer epithelial layer of tympanic membrane	LABEL=Tissue
prostate bud	LABEL=Tissue
thymus lymphoid tissue	LABEL=Tissue
thymus epithelium	LABEL=Tissue
thymus primordium	LABEL=Tissue
palatine tonsil	LABEL=Tissue
cricoid pre-cartilage condensation	LABEL=Tissue
head mesenchyme from mesoderm	LABEL=Tissue
trapezius pre-muscle mass	LABEL=Tissue
stratified columnar epithelium	LABEL=Tissue
nasolacrimal groove	LABEL=Tissue
pharyngotympanic tube epithelium	LABEL=Tissue
tubotympanic recess epithelium	LABEL=Tissue
maxillary process mesenchyme from neural crest	LABEL=Tissue
internal intercostal pre-muscle mass	LABEL=Tissue
skeletal tissue	LABEL=Tissue
myenteric nerve plexus	LABEL=Tissue
endometrium glandular epithelium	LABEL=Tissue
erector spinae pre-muscle mass	LABEL=Tissue
orbitosphenoid cartilage element	LABEL=Tissue
trabecular network of bone	LABEL=Tissue
iris epithelium	LABEL=Tissue
epiphyseal plate	LABEL=Tissue
elastic tissue	LABEL=Tissue
fin field	LABEL=Tissue
lateral line	LABEL=Tissue
septum pellucidum	LABEL=Tissue
epithelium of otic placode	LABEL=Tissue
pars distalis of adenohypophysis	LABEL=Tissue
roof plate	LABEL=Tissue
enveloping layer of ectoderm	LABEL=Tissue
pre-chordal neural plate	LABEL=Tissue
hypochord	LABEL=Tissue
paraxial mesoderm	LABEL=Tissue
pronephric duct	LABEL=Tissue
nephric duct	LABEL=Tissue
primitive streak	LABEL=Tissue
ciliary marginal zone	LABEL=Tissue
eye primordium	LABEL=Tissue
floor plate	LABEL=Tissue
dermomyotome	LABEL=Tissue
cardiogenic splanchnic mesoderm	LABEL=Tissue
supraorbital lateral line	LABEL=Tissue
anterior lateral line	LABEL=Tissue
pharyngeal pouch 2	LABEL=Tissue
pharyngeal pouch	LABEL=Tissue
occipital lateral line	LABEL=Tissue
infraorbital lateral line	LABEL=Tissue
dorsal lateral line	LABEL=Tissue
middle lateral line	LABEL=Tissue
developing neuroepithelium	LABEL=Tissue
dorsal lateral plate region	LABEL=Tissue
Meckel's cartilage pre-cartilage condensation	LABEL=Tissue
chorionic mesenchyme	LABEL=Tissue
blood nerve barrier	LABEL=Tissue
blood-cerebrospinal fluid barrier	LABEL=Tissue
infundibular recess of 3rd ventricle	LABEL=Tissue
epithelium of elbow	LABEL=Tissue
pectoral appendage bud ectoderm	LABEL=Tissue
epithelium of carpal region	LABEL=Tissue
epithelium of hip	LABEL=Tissue
pelvic appendage bud ectoderm	LABEL=Tissue
epithelium of knee	LABEL=Tissue
epithelium of shoulder	LABEL=Tissue
epithelium of upper jaw	LABEL=Tissue
epithelium of lower jaw	LABEL=Tissue
epithelium of superior semicircular canal	LABEL=Tissue
epithelium of posterior semicircular canal	LABEL=Tissue
epithelium of lateral semicircular canal	LABEL=Tissue
epithelium of utricle	LABEL=Tissue
vestibular epithelium	LABEL=Tissue
epithelium of saccule	LABEL=Tissue
epithelium of cochlear duct	LABEL=Tissue
epithelium of endolymphatic sac	LABEL=Tissue
epithelium of forearm	LABEL=Tissue
epithelium of footplate	LABEL=Tissue
ear epithelium	LABEL=Tissue
yolk sac endoderm	LABEL=Tissue
endoderm of midgut	LABEL=Tissue
epithelium of midgut	LABEL=Tissue
endoderm of hindgut	LABEL=Tissue
epithelium of hindgut	LABEL=Tissue
thyroid primordium endoderm	LABEL=Tissue
extraembryonic membrane mesenchyme	LABEL=Tissue
mesenchyme of yolk sac	LABEL=Tissue
mesothelium of omental bursa	LABEL=Tissue
endothelium of trachea	LABEL=Tissue
endothelium of main bronchus	LABEL=Tissue
future hindbrain meninx	LABEL=Tissue
roof plate of midbrain	LABEL=Tissue
roof plate of telencephalon	LABEL=Tissue
roof plate of diencephalon	LABEL=Tissue
roof plate of metencephalon	LABEL=Tissue
roof plate of medulla oblongata	LABEL=Tissue
mesoderm blood island	LABEL=Tissue
mesenchyme of testis	LABEL=Tissue
gonad mesenchyme	LABEL=Tissue
facial mesenchyme	LABEL=Tissue
optic neural crest	LABEL=Tissue
mesenchyme of ovary	LABEL=Tissue
odontogenic papilla of incisor	LABEL=Tissue
incisor mesenchyme	LABEL=Tissue
mesenchyme of elbow	LABEL=Tissue
forelimb mesenchyme	LABEL=Tissue
mesenchyme of carpal region	LABEL=Tissue
mesenchyme of hip	LABEL=Tissue
mesenchyme of knee	LABEL=Tissue
hindlimb mesenchyme	LABEL=Tissue
mesenchyme of shoulder	LABEL=Tissue
mesenchyme of upper jaw	LABEL=Tissue
jaw mesenchyme	LABEL=Tissue
maxillary process mesenchyme	LABEL=Tissue
mesenchyme of lower jaw	LABEL=Tissue
mandibular process mesenchyme	LABEL=Tissue
mesenchyme of pinna	LABEL=Tissue
head mesenchyme	LABEL=Tissue
mesenchyme of mammary gland	LABEL=Tissue
mesenchyme of forearm	LABEL=Tissue
mesenchyme of footplate	LABEL=Tissue
mesenchyme from somatopleure	LABEL=Tissue
pelvic appendage bud mesenchyme	LABEL=Tissue
respiratory system epithelium	LABEL=Tissue
epithelium of rectum	LABEL=Tissue
epithelium of terminal part of digestive tract	LABEL=Tissue
epithelium of incisor	LABEL=Tissue
epithelium of nasal septum	LABEL=Tissue
nose epithelium	LABEL=Tissue
epithelium of tongue	LABEL=Tissue
sensory organ epithelium	LABEL=Tissue
epithelium of soft palate	LABEL=Tissue
epithelium of submandibular gland	LABEL=Tissue
salivary gland epithelium	LABEL=Tissue
epithelium of parotid gland	LABEL=Tissue
epithelium of sublingual gland	LABEL=Tissue
epithelium of endolymphatic duct	LABEL=Tissue
epithelium of ductus reuniens	LABEL=Tissue
epithelium of right lung	LABEL=Tissue
epithelium of left lung	LABEL=Tissue
epithelium of uterine horn	LABEL=Tissue
uterine epithelium	LABEL=Tissue
epithelium of vomeronasal organ	LABEL=Tissue
epithelium of hard palate	LABEL=Tissue
ectoderm of footplate	LABEL=Tissue
cardiac muscle of auricular region	LABEL=Tissue
cardiac muscle tissue of atrium	LABEL=Tissue
cardiac muscle of right atrium	LABEL=Tissue
cardiac muscle of left atrium	LABEL=Tissue
cardiac muscle of right ventricle	LABEL=Tissue
cardiac muscle of left ventricle	LABEL=Tissue
cardiac muscle tissue of interventricular septum	LABEL=Tissue
cardiac muscle tissue of cardiac septum	LABEL=Tissue
interventricular septum muscular part	LABEL=Tissue
skeletal muscle tissue of pharynx	LABEL=Tissue
respiratory system skeletal muscle	LABEL=Tissue
smooth muscle of trachea	LABEL=Tissue
lower respiratory tract smooth muscle	LABEL=Tissue
mesothelium of pericardial cavity	LABEL=Tissue
mesothelium of diaphragm	LABEL=Tissue
mesothelium of pleural cavity	LABEL=Tissue
cartilage of nasal septum	LABEL=Tissue
paired limb/fin bud mesenchyme	LABEL=Tissue
pelvic appendage field	LABEL=Tissue
pectoral appendage bud mesenchyme	LABEL=Tissue
pectoral appendage field	LABEL=Tissue
mesenchyme of mandible	LABEL=Tissue
mesenchyme of nasal septum	LABEL=Tissue
mesenchyme of tongue	LABEL=Tissue
mesenchyme of soft palate	LABEL=Tissue
mesenchyme of submandibular gland	LABEL=Tissue
mesenchyme of parotid	LABEL=Tissue
mesenchyme of sublingual gland	LABEL=Tissue
mesenchyme of vomeronasal organ	LABEL=Tissue
medial nasal process mesenchyme	LABEL=Tissue
mesenchyme of umbilical cord	LABEL=Tissue
mesenchyme of hard palate	LABEL=Tissue
dermis adipose tissue	LABEL=Tissue
dermis connective tissue	LABEL=Tissue
abdominal fat pad	LABEL=Tissue
fat pad	LABEL=Tissue
adipose tissue of abdominal region	LABEL=Tissue
gonadal fat pad	LABEL=Tissue
trabecula carnea cardiac muscle tissue	LABEL=Tissue
large intestine Peyer's patch	LABEL=Tissue
small intestine Peyer's patch	LABEL=Tissue
inner renal medulla loop of Henle	LABEL=Tissue
renal medulla loop of Henle	LABEL=Tissue
respiratory system capillary endothelium	LABEL=Tissue
respiratory system blood vessel endothelium	LABEL=Tissue
respiratory system lymphatic vessel endothelium	LABEL=Tissue
distal convoluted tubule macula densa	LABEL=Tissue
abdominal segment connective tissue	LABEL=Tissue
neck connective tissue	LABEL=Tissue
leg connective tissue	LABEL=Tissue
hindlimb connective tissue	LABEL=Tissue
respiratory system connective tissue	LABEL=Tissue
trachea connective tissue	LABEL=Tissue
mesenchyme of trachea	LABEL=Tissue
chest connective tissue	LABEL=Tissue
arm connective tissue	LABEL=Tissue
forelimb connective tissue	LABEL=Tissue
elbow connective tissue	LABEL=Tissue
wrist connective tissue	LABEL=Tissue
manus connective tissue	LABEL=Tissue
hip connective tissue	LABEL=Tissue
knee connective tissue	LABEL=Tissue
pedal digit connective tissue	LABEL=Tissue
pes connective tissue	LABEL=Tissue
digit connective tissue	LABEL=Tissue
pedal digit mesenchyme	LABEL=Tissue
shoulder connective tissue	LABEL=Tissue
eyelid connective tissue	LABEL=Tissue
eyelid mesenchyme	LABEL=Tissue
nasopharynx connective tissue	LABEL=Tissue
mammary gland connective tissue	LABEL=Tissue
trunk connective tissue	LABEL=Tissue
limb connective tissue	LABEL=Tissue
limb mesenchyme	LABEL=Tissue
main bronchus connective tissue	LABEL=Tissue
bronchus connective tissue	LABEL=Tissue
mesenchyme of main bronchus	LABEL=Tissue
lobar bronchus connective tissue	LABEL=Tissue
lobar bronchus mesenchyme	LABEL=Tissue
thoracic cavity connective tissue	LABEL=Tissue
pelvis connective tissue	LABEL=Tissue
ankle connective tissue	LABEL=Tissue
mesenchyme of tarsal region	LABEL=Tissue
manual digit connective tissue	LABEL=Tissue
manual digit mesenchyme	LABEL=Tissue
mesenchyme of handplate	LABEL=Tissue
tail connective tissue	LABEL=Tissue
trachea pre-cartilage rings	LABEL=Tissue
aorta elastic tissue	LABEL=Tissue
blood vessel elastic tissue	LABEL=Tissue
heart elastic tissue	LABEL=Tissue
cardiovascular system elastic tissue	LABEL=Tissue
respiratory system elastic tissue	LABEL=Tissue
lung elastic tissue	LABEL=Tissue
bronchus elastic tissue	LABEL=Tissue
trachea elastic tissue	LABEL=Tissue
fascia lata	LABEL=Tissue
upper leg connective tissue	LABEL=Tissue
deep fascia	LABEL=Tissue
urogenital sinus epithelium	LABEL=Tissue
prostate field	LABEL=Tissue
dental epithelium	LABEL=Tissue
upper eyelid epithelium	LABEL=Tissue
eyelid epithelium	LABEL=Tissue
lower eyelid epithelium	LABEL=Tissue
telencephalon neural crest	LABEL=Tissue
rhombencephalon neural crest	LABEL=Tissue
spinal cord neural plate	LABEL=Tissue
upper eyelid mesenchyme	LABEL=Tissue
lower eyelid mesenchyme	LABEL=Tissue
anlage	LABEL=Tissue
liver primordium	LABEL=Tissue
epithelium of foregut-midgut junction	LABEL=Tissue
endoderm of foregut-midgut junction	LABEL=Tissue
hypaxial myotome region	LABEL=Tissue
epaxial myotome region	LABEL=Tissue
cardiac jelly	LABEL=Tissue
fenestrated capillary	LABEL=Tissue
splenic sinusoid	LABEL=Tissue
choroid plexus epithelium	LABEL=Tissue
pancreatic epithelial bud	LABEL=Tissue
mesenchyme pectoral fin	LABEL=Tissue
mesenchyme pelvic fin	LABEL=Tissue
blood-air barrier	LABEL=Tissue
tubal tonsil	LABEL=Tissue
anterior stroma of cornea	LABEL=Tissue
posterior stroma of cornea	LABEL=Tissue
cutaneous elastic tissue	LABEL=Tissue
nasal capsule	LABEL=Tissue
cerebellar plate	LABEL=Tissue
rhombomere 1 roof plate	LABEL=Tissue
egg cylinder	LABEL=Tissue
periocular mesenchyme	LABEL=Tissue
spongiotrophoblast layer	LABEL=Tissue
germinal neuroepithelium	LABEL=Tissue
proliferating neuroepithelium	LABEL=Tissue
chorionic plate	LABEL=Tissue
eye trabecular meshwork	LABEL=Tissue
head ectomesenchyme	LABEL=Tissue
neural tube mantle layer	LABEL=Tissue
spleen primary B follicle	LABEL=Tissue
spleen secondary B follicle	LABEL=Tissue
anterior visceral endoderm	LABEL=Tissue
visceral endoderm	LABEL=Tissue
skeletal muscle fiber triad	LABEL=Tissue
neural tube ventricular layer	LABEL=Tissue
differentiating neuroepithelium	LABEL=Tissue
neural tube basal plate	LABEL=Tissue
cortex of humerus	LABEL=Tissue
upper arm connective tissue	LABEL=Tissue
bone tissue of long bone	LABEL=Tissue
tympanic cavity epithelium	LABEL=Tissue
growth plate cartilage	LABEL=Tissue
endochondral bone tissue	LABEL=Tissue
intermediate tubule	LABEL=Tissue
cardiopharyngeal field	LABEL=Tissue
pulmonary myocardium	LABEL=Tissue
anterior ectodermal midgut	LABEL=Tissue
pharyngeal arch mesenchyme from head mesenchyme	LABEL=Tissue
aorta smooth muscle tissue	LABEL=Tissue
prostate epithelial cord	LABEL=Tissue
mammary gland fat	LABEL=Tissue
mammary gland cord	LABEL=Tissue
epithelial cord	LABEL=Tissue
glomerular epithelium	LABEL=Tissue
glomerular endothelium	LABEL=Tissue
loop of Henle ascending limb thin segment	LABEL=Tissue
renal vesicle	LABEL=Tissue
nephrogenic mesenchyme	LABEL=Tissue
nephron progenitor	LABEL=Tissue
kidney epithelium	LABEL=Tissue
urethra smooth muscle layer	LABEL=Tissue
gastrointestinal system smooth muscle	LABEL=Tissue
vagina smooth muscle	LABEL=Tissue
respiratory system smooth muscle	LABEL=Tissue
kidney pelvis smooth muscle	LABEL=Tissue
urinary bladder trigone smooth muscle	LABEL=Tissue
urinary bladder neck smooth muscle	LABEL=Tissue
lymphatic vessel smooth muscle	LABEL=Tissue
mammary gland smooth muscle	LABEL=Tissue
arteriole smooth muscle	LABEL=Tissue
spleen smooth muscle	LABEL=Tissue
gall bladder smooth muscle	LABEL=Tissue
main bronchus smooth muscle	LABEL=Tissue
bronchus smooth muscle	LABEL=Tissue
prostate gland smooth muscle	LABEL=Tissue
muscle tissue of prostate	LABEL=Tissue
oviduct smooth muscle	LABEL=Tissue
outflow tract smooth muscle	LABEL=Tissue
upper leg mesenchyme	LABEL=Tissue
back connective tissue	LABEL=Tissue
lower arm connective tissue	LABEL=Tissue
upper arm mesenchyme	LABEL=Tissue
lower leg mesenchyme	LABEL=Tissue
lateral ventricle choroid plexus epithelium	LABEL=Tissue
third ventricle choroid plexus epithelium	LABEL=Tissue
fourth ventricle choroid plexus epithelium	LABEL=Tissue
heart rudiment	LABEL=Tissue
sacral neural crest	LABEL=Tissue
glomerular capillary endothelium	LABEL=Tissue
respiratory system lymphatic vessel smooth muscle	LABEL=Tissue
respiratory system blood vessel smooth muscle	LABEL=Tissue
limb field	LABEL=Tissue
paired limb/fin field	LABEL=Tissue
Reichert's cartilage pre-cartilage condensation	LABEL=Tissue
bone tissue of epiphysis	LABEL=Tissue
bone tissue of distal epiphysis	LABEL=Tissue
bone tissue of proximal epiphysis	LABEL=Tissue
cardiac muscle tissue of papillary muscle	LABEL=Tissue
skeletal muscle tissue of diaphragm	LABEL=Tissue
skeletal muscle tissue of iliacus	LABEL=Tissue
skeletal muscle tissue of gluteus maximus	LABEL=Tissue
skeletal muscle tissue of quadriceps femoris	LABEL=Tissue
skeletal muscle tissue of tibialis anterior	LABEL=Tissue
skeletal muscle tissue of deltoid	LABEL=Tissue
skeletal muscle tissue of teres major	LABEL=Tissue
skeletal muscle tissue of biceps brachii	LABEL=Tissue
skeletal muscle tissue of digastric	LABEL=Tissue
skeletal muscle tissue of mylohyoid	LABEL=Tissue
skeletal muscle tissue of orbicularis oculi	LABEL=Tissue
skeletal muscle tissue of masseter	LABEL=Tissue
skeletal muscle tissue of temporalis	LABEL=Tissue
skeletal muscle tissue of levator palpebrae superioris	LABEL=Tissue
skeletal muscle tissue of trapezius	LABEL=Tissue
skeletal muscle tissue of pectoralis major	LABEL=Tissue
skeletal muscle tissue of rectus abdominis	LABEL=Tissue
skeletal muscle tissue of supraspinatus	LABEL=Tissue
skeletal muscle tissue of internal intercostal muscle	LABEL=Tissue
skeletal muscle tissue of transversus thoracis	LABEL=Tissue
smooth muscle tissue of bronchiole	LABEL=Tissue
smooth muscle tissue of terminal bronchiole	LABEL=Tissue
smooth muscle tissue of respiratory bronchiole	LABEL=Tissue
striated muscle tissue of prostate	LABEL=Tissue
cardiac muscle tissue of trabecula carnea of right ventricle	LABEL=Tissue
cardiac muscle tissue of trabecula carnea of left ventricle	LABEL=Tissue
epididymis epithelium	LABEL=Tissue
third ventricle ependyma	LABEL=Tissue
ependyma	LABEL=Tissue
brain ependyma	LABEL=Tissue
lateral ventricle ependyma	LABEL=Tissue
fourth ventricle ependyma	LABEL=Tissue
urinary bladder urothelium	LABEL=Tissue
esophagus muscularis mucosa	LABEL=Tissue
tongue keratinized epithelium	LABEL=Tissue
keratinized stratified squamous epithelium	LABEL=Tissue
tongue squamous epithelium	LABEL=Tissue
ciliated epithelium	LABEL=Tissue
external naris epithelium	LABEL=Tissue
naris epithelium	LABEL=Tissue
Peyer's patch epithelium	LABEL=Tissue
Harderian gland epithelium	LABEL=Tissue
venous system smooth muscle	LABEL=Tissue
Peyer's patch germinal center	LABEL=Tissue
vena cava endothelium	LABEL=Tissue
outflow tract endothelium	LABEL=Tissue
heart endothelium	LABEL=Tissue
corpus cavernosum penis	LABEL=Tissue
corpus cavernosum	LABEL=Tissue
annulus fibrosus disci intervertebralis	LABEL=Tissue
annulus fibrosus	LABEL=Tissue
fibrous ring of heart	LABEL=Tissue
primitive renal collecting duct system	LABEL=Tissue
mandibular process mesenchyme from neural crest	LABEL=Tissue
head paraxial mesoderm	LABEL=Tissue
intramembranous bone tissue	LABEL=Tissue
urethra urothelium	LABEL=Tissue
kidney pelvis urothelium	LABEL=Tissue
cervix epithelium	LABEL=Tissue
respiratory tract epithelium	LABEL=Tissue
pseudostratified ciliated columnar epithelium	LABEL=Tissue
penis epithelium	LABEL=Tissue
seminal vesicle epithelium	LABEL=Tissue
epithelium of male gonad	LABEL=Tissue
vas deferens epithelium	LABEL=Tissue
nephron tubule epithelium	LABEL=Tissue
endometrium epithelium	LABEL=Tissue
male prepuce epithelium	LABEL=Tissue
seminiferous tubule epithelium	LABEL=Tissue
larynx epithelium	LABEL=Tissue
lacrimal gland epithelium	LABEL=Tissue
terminal bronchus epithelium	LABEL=Tissue
bile duct epithelium	LABEL=Tissue
epithelium of biliary system	LABEL=Tissue
pulmonary alveolus epithelium	LABEL=Tissue
extrahepatic bile duct epithelium	LABEL=Tissue
intrahepatic bile duct epithelium	LABEL=Tissue
dental lamina	LABEL=Tissue
urethra skeletal muscle tissue	LABEL=Tissue
esophagus skeletal muscle	LABEL=Tissue
lip skeletal muscle	LABEL=Tissue
hepatic duct smooth muscle	LABEL=Tissue
epididymis smooth muscle	LABEL=Tissue
respiratory system arterial endothelium	LABEL=Tissue
respiratory system venous endothelium	LABEL=Tissue
lymph node endothelium	LABEL=Tissue
aorta endothelium	LABEL=Tissue
skeletal muscle connective tissue	LABEL=Tissue
cellular cartilage	LABEL=Tissue
tapetum lucidum of camera-type eye	LABEL=Tissue
tapetum	LABEL=Tissue
distal visceral endoderm	LABEL=Tissue
alveolar smooth muscle	LABEL=Tissue
right lung accessory lobe lobar bronchus mesenchyme	LABEL=Tissue
right lung lobar bronchus mesenchyme	LABEL=Tissue
right lung cranial lobe lobar bronchus mesenchyme	LABEL=Tissue
right lung middle lobe lobar bronchus mesenchyme	LABEL=Tissue
right lung associated mesenchyme	LABEL=Tissue
embryonic cloacal epithelium	LABEL=Tissue
epithelium of gonad	LABEL=Tissue
tympanic membrane epithelium	LABEL=Tissue
epithelial fold	LABEL=Tissue
head fold of embryonic disc	LABEL=Tissue
lamina terminalis of neural tube	LABEL=Tissue
nipple sheath	LABEL=Tissue
kidney field	LABEL=Tissue
renal connecting tubule	LABEL=Tissue
short descending thin limb	LABEL=Tissue
long descending thin limb	LABEL=Tissue
early distal convoluted tubule	LABEL=Tissue
late distal convoluted tubule	LABEL=Tissue
anterior mesonephric tubule	LABEL=Tissue
posterior mesonephric tubule	LABEL=Tissue
metanephric tubule	LABEL=Tissue
metanephric epithelium	LABEL=Tissue
metanephric smooth muscle tissue	LABEL=Tissue
primitive metanephric nephron	LABEL=Tissue
metanephric capsule	LABEL=Tissue
metanephric cortex mesenchyme	LABEL=Tissue
metanephric ascending thin limb	LABEL=Tissue
metanephric nephron tubule	LABEL=Tissue
metanephric distal tubule	LABEL=Tissue
metanephric loop of Henle	LABEL=Tissue
metanephric distal convoluted tubule	LABEL=Tissue
metanephric early distal convoluted tubule	LABEL=Tissue
metanephric nephron epithelium	LABEL=Tissue
metanephric late distal convoluted tubule	LABEL=Tissue
metanephric macula densa	LABEL=Tissue
metanephric proximal convoluted tubule	LABEL=Tissue
metanephric proximal straight tubule	LABEL=Tissue
metanephric proximal tubule	LABEL=Tissue
metanephric thick ascending limb	LABEL=Tissue
metanephric glomerular epithelium	LABEL=Tissue
metanephric glomerular endothelium	LABEL=Tissue
metanephric long descending thin limb	LABEL=Tissue
metanephric short descending thin limb	LABEL=Tissue
metanephric renal vesicle	LABEL=Tissue
metanephric connecting tubule	LABEL=Tissue
spleen germinal center	LABEL=Tissue
distal straight tubule macula densa	LABEL=Tissue
optic eminence surface ectoderm	LABEL=Tissue
optic eminence ectoderm	LABEL=Tissue
upper leg epithelium	LABEL=Tissue
pedal digit epithelium	LABEL=Tissue
manual digit epithelium	LABEL=Tissue
epithelium of handplate	LABEL=Tissue
upper arm epithelium	LABEL=Tissue
lower leg epithelium	LABEL=Tissue
medial-nasal process ectoderm	LABEL=Tissue
frontonasal process epithelium	LABEL=Tissue
basal plate medulla oblongata	LABEL=Tissue
roof plate spinal cord region	LABEL=Tissue
digit mesenchyme	LABEL=Tissue
atrium cardiac jelly	LABEL=Tissue
ventricle cardiac jelly	LABEL=Tissue
outflow tract cardiac jelly	LABEL=Tissue
sex cord	LABEL=Tissue
primitive sex cord of indifferent gonad	LABEL=Tissue
pearly penile papule	LABEL=Tissue
submucous nerve plexus	LABEL=Tissue
pronephric nephron tubule	LABEL=Tissue
primary ureteric bud	LABEL=Tissue
mammary duct terminal end bud	LABEL=Tissue
alveolar primary septum	LABEL=Tissue
alveolar secondary septum	LABEL=Tissue
pulmonary artery endothelium	LABEL=Tissue
mesonephric smooth muscle tissue	LABEL=Tissue
mesonephric mesenchyme	LABEL=Tissue
mesonephric macula densa	LABEL=Tissue
mesonephric nephron epithelium	LABEL=Tissue
mesonephric glomerular epithelium	LABEL=Tissue
mesonephric nephron tubule	LABEL=Tissue
mesonephric renal vesicle	LABEL=Tissue
primitive mesonephric nephron	LABEL=Tissue
Rathke's pouch	LABEL=Tissue
spinal cord ependyma	LABEL=Tissue
spinal cord ventricular layer	LABEL=Tissue
nasal cavity respiratory epithelium	LABEL=Tissue
pararenal fat	LABEL=Tissue
perirenal fat	LABEL=Tissue
zone of polarizing activity	LABEL=Tissue
zone of polarizing activity of pectoral appendage	LABEL=Tissue
zone of polarizing activity of pelvic appendage	LABEL=Tissue
embryonic cisterna chyli	LABEL=Tissue
external intercostal pre-muscle mass	LABEL=Tissue
external oblique pre-muscle mass	LABEL=Tissue
filum terminale	LABEL=Tissue
inferior mesenteric nerve plexus	LABEL=Tissue
levator scapulae pre-muscle mass	LABEL=Tissue
stomach fundus epithelium	LABEL=Tissue
superior mesenteric plexus	LABEL=Tissue
mesenteric plexus	LABEL=Tissue
hyoid pre-muscle mass	LABEL=Tissue
intermediate mesenchyme	LABEL=Tissue
non-neural ectoderm	LABEL=Tissue
rhombomere floor plate	LABEL=Tissue
rhombomere roof plate	LABEL=Tissue
trigeminal neural crest	LABEL=Tissue
facio-acoustic neural crest	LABEL=Tissue
rhombomere 1 floor plate	LABEL=Tissue
rhombomere 2 floor plate	LABEL=Tissue
rhombomere 2 roof plate	LABEL=Tissue
rhombomere 3 floor plate	LABEL=Tissue
rhombomere 3 roof plate	LABEL=Tissue
rhombomere 4 floor plate	LABEL=Tissue
rhombomere 4 roof plate	LABEL=Tissue
rhombomere 5 floor plate	LABEL=Tissue
rhombomere 5 roof plate	LABEL=Tissue
rhombomere 6 floor plate	LABEL=Tissue
rhombomere 6 roof plate	LABEL=Tissue
rhombomere 7 floor plate	LABEL=Tissue
rhombomere 7 roof plate	LABEL=Tissue
rhombomere 8 floor plate	LABEL=Tissue
rhombomere 8 roof plate	LABEL=Tissue
trunk somite	LABEL=Tissue
lens equatorial epithelium	LABEL=Tissue
rhomboid pre-muscle mass	LABEL=Tissue
pharyngeal pouch 1	LABEL=Tissue
caecum epithelium	LABEL=Tissue
pyloric region epithelium	LABEL=Tissue
anterior chamber epithelium	LABEL=Tissue
right lung cranial lobe epithelium	LABEL=Tissue
right lung caudal lobe epithelium	LABEL=Tissue
ultimobranchial body epithelium	LABEL=Tissue
foregut duodenum epithelium	LABEL=Tissue
duodenal epithelium	LABEL=Tissue
midgut duodenum epithelium	LABEL=Tissue
manual digit 2 epithelium	LABEL=Tissue
manual digit 3 epithelium	LABEL=Tissue
manual digit 4 epithelium	LABEL=Tissue
manual digit 5 epithelium	LABEL=Tissue
pedal digit 2 epithelium	LABEL=Tissue
pedal digit 3 epithelium	LABEL=Tissue
pedal digit 4 epithelium	LABEL=Tissue
pedal digit 5 epithelium	LABEL=Tissue
upper jaw molar epithelium	LABEL=Tissue
molar epithelium	LABEL=Tissue
oral epithelium from ectoderm	LABEL=Tissue
lower jaw molar epithelium	LABEL=Tissue
right lung accessory lobe epithelium	LABEL=Tissue
lens vesicle epithelium	LABEL=Tissue
crus commune epithelium	LABEL=Tissue
secondary palatal shelf epithelium	LABEL=Tissue
primary palate epithelium	LABEL=Tissue
maxillary process ectoderm	LABEL=Tissue
2nd arch ectoderm	LABEL=Tissue
3rd arch ectoderm	LABEL=Tissue
4th arch ectoderm	LABEL=Tissue
2nd arch endoderm	LABEL=Tissue
4th arch endoderm	LABEL=Tissue
connecting stalk mesoderm	LABEL=Tissue
extraembryonic mesoderm	LABEL=Tissue
peritoneal cavity mesothelium	LABEL=Tissue
greater omentum mesothelium	LABEL=Tissue
greater sac mesothelium	LABEL=Tissue
right lung endothelium	LABEL=Tissue
left lung endothelium	LABEL=Tissue
right lung cranial lobe endothelium	LABEL=Tissue
right lung caudal lobe endothelium	LABEL=Tissue
right lung accessory lobe endothelium	LABEL=Tissue
sphenoid lesser wing pre-cartilage condensation	LABEL=Tissue
2nd arch mesenchyme	LABEL=Tissue
pharyngeal arch mesenchymal region	LABEL=Tissue
3rd arch mesenchyme	LABEL=Tissue
4th arch mesenchyme	LABEL=Tissue
manual digit 2 mesenchyme	LABEL=Tissue
manual digit 3 mesenchyme	LABEL=Tissue
manual digit 4 mesenchyme	LABEL=Tissue
manual digit 5 mesenchyme	LABEL=Tissue
pedal digit 2 mesenchyme	LABEL=Tissue
pedal digit 3 mesenchyme	LABEL=Tissue
pedal digit 4 mesenchyme	LABEL=Tissue
pedal digit 5 mesenchyme	LABEL=Tissue
upper jaw molar odontogenic papilla	LABEL=Tissue
molar dental papilla	LABEL=Tissue
lower jaw molar odontogenic papilla	LABEL=Tissue
optic eminence mesenchyme	LABEL=Tissue
secondary palatal shelf mesenchyme	LABEL=Tissue
primary palate mesenchyme	LABEL=Tissue
1st arch maxillary mesenchyme from neural crest	LABEL=Tissue
upper jaw incisor odontogenic papilla	LABEL=Tissue
lower jaw incisor odontogenic papilla	LABEL=Tissue
upper jaw incisor epithelium	LABEL=Tissue
lower jaw incisor epithelium	LABEL=Tissue
pharyngeal pouch 3	LABEL=Tissue
glomerular parietal epithelium	LABEL=Tissue
visceral layer of glomerular capsule	LABEL=Tissue
cortex of manus bone	LABEL=Tissue
pre-cartilage condensation	LABEL=Tissue
pre-muscle condensation	LABEL=Tissue
pharyngeal cleft	LABEL=Tissue
2nd arch pharyngeal cleft	LABEL=Tissue
3rd arch pharyngeal cleft	LABEL=Tissue
4th arch pharyngeal cleft	LABEL=Tissue
pharyngeal ectoderm	LABEL=Tissue
neural tube lateral wall mantle layer	LABEL=Tissue
gonad germinal epithelium	LABEL=Tissue
coelomic epithelium	LABEL=Tissue
mesonephric early distal tubule	LABEL=Tissue
transitional epithelium of major calyx	LABEL=Tissue
bulb of hair follicle	LABEL=Tissue
hair root sheath	LABEL=Tissue
hair inner root sheath	LABEL=Tissue
hair outer root sheath	LABEL=Tissue
hair root sheath matrix	LABEL=Tissue
conotruncal ridge	LABEL=Tissue
hair follicle bulge	LABEL=Tissue
skin epithelium	LABEL=Tissue
Bachmann's bundle	LABEL=Tissue
left branch of atrioventricular bundle	LABEL=Tissue
right branch of atrioventricular bundle	LABEL=Tissue
aortic valve anulus	LABEL=Tissue
pulmonary valve anulus	LABEL=Tissue
tricuspid valve anulus	LABEL=Tissue
hair follicle matrix region	LABEL=Tissue
hair follicle isthmus	LABEL=Tissue
future falx cerebri	LABEL=Tissue
urogenital sinus mesenchyme	LABEL=Tissue
mesonephric capsule	LABEL=Tissue
pronephric proximal tubule	LABEL=Tissue
pronephric distal tubule	LABEL=Tissue
mesonephric connecting tubule	LABEL=Tissue
mesonephric distal tubule	LABEL=Tissue
mesonephric proximal tubule	LABEL=Tissue
basioccipital pre-cartilage condensation	LABEL=Tissue
carpus pre-cartilage condensation	LABEL=Tissue
exoccipital pre-cartilage condensation	LABEL=Tissue
femur pre-cartilage condensation	LABEL=Tissue
future central tendon	LABEL=Tissue
central tendon of diaphragm	LABEL=Tissue
humerus pre-cartilage condensation	LABEL=Tissue
iliac pre-cartilage condensation	LABEL=Tissue
1st arch mesenchyme	LABEL=Tissue
ischial pre-cartilage condensation	LABEL=Tissue
1st arch maxillary ectoderm	LABEL=Tissue
pleuroperitoneal canal	LABEL=Tissue
pubic pre-cartilage condensation	LABEL=Tissue
radius pre-cartilage condensation	LABEL=Tissue
radius-ulna pre-cartilage condensation	LABEL=Tissue
rib pre-cartilage condensation	LABEL=Tissue
shoulder joint primordium	LABEL=Tissue
ulna pre-cartilage condensation	LABEL=Tissue
base of arytenoid	LABEL=Tissue
posterior lateral line	LABEL=Tissue
distal early tubule	LABEL=Tissue
ureteric bud tip	LABEL=Tissue
premacula segment of distal straight tubule	LABEL=Tissue
outer medulla inner stripe loop of Henle	LABEL=Tissue
basisphenoid cartilage condenstion	LABEL=Tissue
xiphoid cartilage	LABEL=Tissue
xiphoid process bone	LABEL=Tissue
apex of arytenoid	LABEL=Tissue
outer renal medulla loop of Henle	LABEL=Tissue
corpus cavernosum clitoridis	LABEL=Tissue
erectile tissue	LABEL=Tissue
male paramesonephric duct	LABEL=Tissue
dartos muscle	LABEL=Tissue
orbital fat pad	LABEL=Tissue
trachealis	LABEL=Tissue
radius-ulna cartilage element	LABEL=Tissue
alisphenoid cartilage element	LABEL=Tissue
dorsal part of pharyngeal pouch 3	LABEL=Tissue
epithelium of conjunctiva	LABEL=Tissue
non-keratinized stratified squamous epithelium	LABEL=Tissue
long bone epiphyseal plate proliferative zone	LABEL=Tissue
zone of epiphyseal plate	LABEL=Tissue
long bone epiphyseal plate hypertrophic zone	LABEL=Tissue
long bone epiphyseal plate ossification zone	LABEL=Tissue
glandular epithelium	LABEL=Tissue
non-glandular epithelium	LABEL=Tissue
cutaneous muscle	LABEL=Tissue
glomerular visceral epithelium	LABEL=Tissue
distal straight tubule postmacula segment	LABEL=Tissue
slow muscle tissue	LABEL=Tissue
fast muscle tissue	LABEL=Tissue
urinary bladder muscularis mucosa	LABEL=Tissue
lip epithelium	LABEL=Tissue
non-keratinized epithelium of tongue	LABEL=Tissue
parakeratinized epithelium of tongue	LABEL=Tissue
parakeratinized epithelium	LABEL=Tissue
esophagus squamous epithelium	LABEL=Tissue
stomach squamous epithelium	LABEL=Tissue
cervix squamous epithelium	LABEL=Tissue
vagina squamous epithelium	LABEL=Tissue
glandular columnar epithelium	LABEL=Tissue
glandular cuboidal epithelium	LABEL=Tissue
crista ampullaris neuroepithelium	LABEL=Tissue
thymus subcapsular epithelium	LABEL=Tissue
pinna surface epithelium	LABEL=Tissue
outer ear epithelium	LABEL=Tissue
efferent duct epithelium	LABEL=Tissue
cervical loop	LABEL=Tissue
inner dental epithelium	LABEL=Tissue
outer dental epithelium	LABEL=Tissue
stellate reticulum	LABEL=Tissue
ejaculatory duct epithelium	LABEL=Tissue
mammary gland myoepithelium	LABEL=Tissue
submandibular gland primordium epithelium	LABEL=Tissue
anterior lateral plate mesoderm	LABEL=Tissue
chordo neural hinge	LABEL=Tissue
mandibular neural crest	LABEL=Tissue
hyoid neural crest	LABEL=Tissue
pharyngeal pouch 4	LABEL=Tissue
pharyngeal pouch 5	LABEL=Tissue
pharyngeal pouch 6	LABEL=Tissue
parietal mesothelium	LABEL=Tissue
visceral mesothelium	LABEL=Tissue
muscularis mucosae of colon	LABEL=Tissue
basal cell layer of urothelium	LABEL=Tissue
pericardio-peritoneal canal mesothelium	LABEL=Tissue
pericardial visceral mesothelium	LABEL=Tissue
pericardial parietal mesothelium	LABEL=Tissue
mesothelium of serous pericardium	LABEL=Tissue
ciliated columnar epithelium	LABEL=Tissue
mesenchyme derived from trunk neural crest	LABEL=Tissue
lingual tonsil	LABEL=Tissue
crista of ampulla of anterior semicircular duct of membranous laybrinth	LABEL=Tissue
crista of ampulla of posterior semicircular duct of membranous laybrinth	LABEL=Tissue
crista of ampulla of lateral semicircular duct of membranous laybrinth	LABEL=Tissue
trunk paraxial mesoderm	LABEL=Tissue
pronephric proximal convoluted tubule	LABEL=Tissue
pronephric distal early tubule	LABEL=Tissue
bony part of pharyngotympanic tube	LABEL=Tissue
paired limb/fin cartilage	LABEL=Tissue
pectoral appendage cartilage tissue	LABEL=Tissue
stratum intermedium of tooth	LABEL=Tissue
regeneration epithelium of fin/limb	LABEL=Tissue
ciliated columnar oviduct epithelium	LABEL=Tissue
cuboidal oviduct epithelium	LABEL=Tissue
stratified cuboidal epithelium	LABEL=Tissue
ciliated stratified columnar epithelium	LABEL=Tissue
pigment epithelium of eye	LABEL=Tissue
capillary loop nephron	LABEL=Tissue
maturing nephron	LABEL=Tissue
facial neural crest	LABEL=Tissue
lateral mesenchyme derived from mesoderm	LABEL=Tissue
entire pharyngeal arch endoderm	LABEL=Tissue
umbilical vein endothelium	LABEL=Tissue
umbilical artery endothelium	LABEL=Tissue
connecting stalk blood islands	LABEL=Tissue
fascia of Camper	LABEL=Tissue
abdominal fascia	LABEL=Tissue
panniculus adiposus	LABEL=Tissue
major alar cartilage	LABEL=Tissue
minor alar cartilage	LABEL=Tissue
accessory nasal cartilage	LABEL=Tissue
lateral nasal cartilage	LABEL=Tissue
vomeronasal cartilage	LABEL=Tissue
regular connective tissue	LABEL=Tissue
irregular connective tissue	LABEL=Tissue
perichordal tissue	LABEL=Tissue
hypertrophic cartilage zone	LABEL=Tissue
tendon of biceps brachii	LABEL=Tissue
tendon of triceps brachii	LABEL=Tissue
nacre	LABEL=Tissue
rumen epithelium	LABEL=Tissue
stomach non-glandular epithelium	LABEL=Tissue
inner chondrogenic layer of perichondrium	LABEL=Tissue
outer fibrous layer of perichondrium	LABEL=Tissue
clitoral smooth muscle	LABEL=Tissue
microvascular endothelium	LABEL=Tissue
ileal epithelium	LABEL=Tissue
breast epithelium	LABEL=Tissue
tracheobronchial epithelium	LABEL=Tissue
proximal tubular epithelium	LABEL=Tissue
distal tubular epithelium	LABEL=Tissue
buccal epithelium	LABEL=Tissue
ceratoglossus	LABEL=Tissue
thymus primordium endoderm	LABEL=Tissue
visceral yolk sac	LABEL=Tissue
parietal yolk sac	LABEL=Tissue
osteoid	LABEL=Tissue
extraembryonic endoderm	LABEL=Tissue
core of melon organ	LABEL=Tissue
fascia	LABEL=Tissue
periurethral tissue	LABEL=Tissue
white fibrocartilage	LABEL=Tissue
lymph node germinal center	LABEL=Tissue
lymph node secondary follicle	LABEL=Tissue
gill filament	LABEL=Tissue
right atrium endocardium	LABEL=Tissue
pleuroperitoneal membrane	LABEL=Tissue
sphenoid bone pre-cartilage condensation	LABEL=Tissue
basisphenoid pre-cartilage condensation	LABEL=Tissue
limb epidermis	LABEL=Tissue
mesenchyme of fronto-nasal process	LABEL=Tissue
lateral nasal process mesenchyme	LABEL=Tissue
lateral nasal process surface ectoderm	LABEL=Tissue
associated mesenchyme of otic placode	LABEL=Tissue
associated mesenchyme of midgut	LABEL=Tissue
mesenchyme from splanchnopleure	LABEL=Tissue
ectoderm of buccopharyngeal membrane	LABEL=Tissue
endoderm of buccopharyngeal membrane	LABEL=Tissue
associated mesenchyme of foregut-midgut junction	LABEL=Tissue
entire pharyngeal arch associated mesenchyme	LABEL=Tissue
extrahepatic part of biliary bud	LABEL=Tissue
intrahepatic part of biliary bud	LABEL=Tissue
parietal of mesothelium of pericardio-peritoneal canal	LABEL=Tissue
periotic mesenchyme	LABEL=Tissue
mesenchyme of hindgut	LABEL=Tissue
mesenchyme of middle ear	LABEL=Tissue
1st arch maxillary mesenchyme	LABEL=Tissue
anal membrane endodermal component	LABEL=Tissue
lateral lingual swelling epithelium	LABEL=Tissue
mesenchyme of sublingual gland primordium	LABEL=Tissue
mesenchyme of submandibular gland primordium	LABEL=Tissue
hepatic sinusoid of left of lobe of liver	LABEL=Tissue
hepatic sinusoid of right of lobe of liver	LABEL=Tissue
myelencephalon basal plate	LABEL=Tissue
diencephalon mantle layer	LABEL=Tissue
midbrain mantle layer	LABEL=Tissue
spinal cord mantle layer	LABEL=Tissue
1st arch mandibular mesenchyme	LABEL=Tissue
interdigital region mesenchyme	LABEL=Tissue
mesenchyme of interdigital region between manual digits 1 and 2	LABEL=Tissue
mesenchyme of interdigital region between digits 1 and 2	LABEL=Tissue
mesenchyme of interdigital region of manus	LABEL=Tissue
mesenchyme of interdigital region between manual digits 2 and 3	LABEL=Tissue
mesenchyme of interdigital region between digits 2 and 3	LABEL=Tissue
mesenchyme of interdigital region between manual digits 3 and 4	LABEL=Tissue
mesenchyme of interdigital region between digits 3 and 4	LABEL=Tissue
mesenchyme of interdigital region between manual digits 4 and 5	LABEL=Tissue
mesenchyme of interdigital region between digits 4 and 5	LABEL=Tissue
mesenchyme of interdigital region between pedal digits 1 and 2	LABEL=Tissue
mesenchyme of interdigital region of pes	LABEL=Tissue
mesenchyme of interdigital region between pedal digits 2 and 3	LABEL=Tissue
mesenchyme of interdigital region between pedal digits 3 and 4	LABEL=Tissue
mesenchyme of interdigital region between pedal digits 4 and 5	LABEL=Tissue
left lung associated mesenchyme	LABEL=Tissue
forebrain neural plate	LABEL=Tissue
midbrain neural plate	LABEL=Tissue
hindbrain neural plate	LABEL=Tissue
midbrain neural tube	LABEL=Tissue
tail bud paraxial mesoderm	LABEL=Tissue
tail somite	LABEL=Tissue
pronephric proximal straight tubule	LABEL=Tissue
trachea non-cartilage connective tissue	LABEL=Tissue
middle ear epithelium	LABEL=Tissue
eyelid subcutaneous connective tissue	LABEL=Tissue
nasal fin	LABEL=Tissue
epithelium of laryngopharynx	LABEL=Tissue
epithelium of appendix	LABEL=Tissue
endocardium of right ventricle	LABEL=Tissue
endocardium of left ventricle	LABEL=Tissue
tail fold of embryonic disc	LABEL=Tissue
cephalic neural fold	LABEL=Tissue
pancreas mesenchyme	LABEL=Tissue
blubber	LABEL=Tissue
cardiac muscle tissue of right auricle	LABEL=Tissue
cardiac muscle tissue of left auricle	LABEL=Tissue
cloacal epithelium	LABEL=Tissue
posterior lateral plate mesoderm	LABEL=Tissue
ureter smooth muscle	LABEL=Tissue
dentate gyrus subgranular zone	LABEL=Tissue
preplacodal ectoderm	LABEL=Tissue
internodal tract	LABEL=Tissue
statoacoustic epithelium	LABEL=Tissue
epithelium of pancreatic duct	LABEL=Tissue
exocrine pancreas epithelium	LABEL=Tissue
Rathkes pouch epithelium	LABEL=Tissue
dorsal part of pharyngeal pouch 1	LABEL=Tissue
ventral part of pharyngeal pouch 1	LABEL=Tissue
ventral part of pharyngeal pouch 2	LABEL=Tissue
ventral part of pharyngeal pouch 3	LABEL=Tissue
dorsal part of pharyngeal pouch 4	LABEL=Tissue
ventral part of pharyngeal pouch 4	LABEL=Tissue
dorsal part of pharyngeal pouch 5	LABEL=Tissue
ventral part of pharyngeal pouch 5	LABEL=Tissue
6th arch mesenchyme	LABEL=Tissue
epithelial sheet	LABEL=Tissue
polarized epithelium	LABEL=Tissue
granulation tissue	LABEL=Tissue
laryngeal associated mesenchyme	LABEL=Tissue
arytenoid swellings	LABEL=Tissue
placodal ectoderm	LABEL=Tissue
choroid tapetum lucidum	LABEL=Tissue
retinal tapetum lucidum	LABEL=Tissue
choroidal guanine tapetum	LABEL=Tissue
choroidal tapetum cellulosum	LABEL=Tissue
choroidal tapetum fibrosum	LABEL=Tissue
1st arch mandibular mesenchyme from neural crest	LABEL=Tissue
1st arch mesenchyme from neural crest	LABEL=Tissue
2nd arch mesenchyme from neural crest	LABEL=Tissue
pharyngeal arch mesenchyme from neural crest	LABEL=Tissue
3rd arch mesenchyme from neural crest	LABEL=Tissue
4th arch mesenchyme from neural crest	LABEL=Tissue
6th arch mesenchyme from neural crest	LABEL=Tissue
filum terminale internum	LABEL=Tissue
filum terminale externum	LABEL=Tissue
scleral endothelium	LABEL=Tissue
scleral mesenchyme	LABEL=Tissue
epithelial scleral papilla layer	LABEL=Tissue
amnioserosa	LABEL=Tissue
extraembryonic epithelium	LABEL=Tissue
limb bud mesenchyme	LABEL=Tissue
maxillary process mesenchyme from head mesenchyme	LABEL=Tissue
1st arch maxillary mesenchyme from head mesenchyme	LABEL=Tissue
mandibular process mesenchyme from head mesenchyme	LABEL=Tissue
1st arch mandibular mesenchyme from head mesenchyme	LABEL=Tissue
1st arch mesenchyme from head mesenchyme	LABEL=Tissue
2nd arch mesenchyme from head mesenchyme	LABEL=Tissue
3rd arch mesenchyme from head mesenchyme	LABEL=Tissue
4th arch mesenchyme from head mesenchyme	LABEL=Tissue
6th arch mesenchyme from head mesenchyme	LABEL=Tissue
superior tarsal muscle	LABEL=Tissue
Peyer's patch follicle	LABEL=Tissue
lymph node primary follicle	LABEL=Tissue
lymph node follicle	LABEL=Tissue
lateral ventricle subependymal layer	LABEL=Tissue
inguinal fat pad	LABEL=Tissue
retroperitoneal fat pad	LABEL=Tissue
epididymal fat pad	LABEL=Tissue
parametrial fat pad	LABEL=Tissue
uterine fat pad	LABEL=Tissue
mesenteric fat pad	LABEL=Tissue
omental fat pad	LABEL=Tissue
lymph node follicular corona	LABEL=Tissue
secondary follicle corona	LABEL=Tissue
spleen B cell corona	LABEL=Tissue
primary lymphoid nodule of tonsil	LABEL=Tissue
pseudostratified columnar epithelium	LABEL=Tissue
pseudostratified smooth columnar epithelium	LABEL=Tissue
mesonephric nephron progenitor	LABEL=Tissue
tarsus pre-cartilage condensation	LABEL=Tissue
pedal digit 1 metatarsal pre-cartilage condensation	LABEL=Tissue
pedal digit metatarsal pre-cartilage condensation	LABEL=Tissue
pedal digit 2 metatarsal pre-cartilage condensation	LABEL=Tissue
pedal digit 3 metatarsal pre-cartilage condensation	LABEL=Tissue
pedal digit 4 metatarsal pre-cartilage condensation	LABEL=Tissue
pedal digit 5 metatarsal pre-cartilage condensation	LABEL=Tissue
pedal digit 1 mesenchyme	LABEL=Tissue
manual digit 1 mesenchyme	LABEL=Tissue
manual digit 1 epithelium	LABEL=Tissue
pedal digit 1 epithelium	LABEL=Tissue
alisphenoid pre-cartilage condensation	LABEL=Tissue
spleen follicular dendritic cell network	LABEL=Tissue
calcaneum pre-cartilage condensation	LABEL=Tissue
clavicle pre-cartilage condensation	LABEL=Tissue
tibia pre-cartilage condensation	LABEL=Tissue
fibula pre-cartilage condensation	LABEL=Tissue
tarsometatarsus pre-cartilage condensation	LABEL=Tissue
tibiotarsus pre-cartilage condensation	LABEL=Tissue
transverospinalis pre-muscle mass	LABEL=Tissue
articular cartilage of joint	LABEL=Tissue
endocardium of right auricle	LABEL=Tissue
cuneiform cartilage	LABEL=Tissue
supraoccipital pre-cartilage condensation	LABEL=Tissue
epithelium of crypt of Lieberkuhn	LABEL=Tissue
ophthalmic plexus	LABEL=Tissue
inferior parathyroid epithelium	LABEL=Tissue
parathyroid epithelium	LABEL=Tissue
superior parathyroid epithelium	LABEL=Tissue
urachus epithelium	LABEL=Tissue
urachus mesenchyme	LABEL=Tissue
medial migration pathway NC-derived mesenchyme	LABEL=Tissue
migration pathway NC-derived mesenchyme	LABEL=Tissue
lateral migration pathway NC-derived mesenchyme	LABEL=Tissue
visceral fascia	LABEL=Tissue
temporalis fascia	LABEL=Tissue
pharyngeal nerve plexus	LABEL=Tissue
palatine raphe	LABEL=Tissue
raphe of hard palate	LABEL=Tissue
raphe of soft palate	LABEL=Tissue
mylohyoid raphe	LABEL=Tissue
blood vessel internal elastic membrane	LABEL=Tissue
cutaneous trunci muscle	LABEL=Tissue
levator nasolabialis muscle	LABEL=Tissue
chondroglossus muscle	LABEL=Tissue
odontogenic mesenchyme of molar	LABEL=Tissue
perichordal ring	LABEL=Tissue
pre-enameloid	LABEL=Tissue
caudate lobe hepatic sinusoid	LABEL=Tissue
quadrate lobe hepatic sinusoid	LABEL=Tissue
dermal pulp of feather shaft	LABEL=Tissue
feather bud, dermal component	LABEL=Tissue
feather bud, epidermal component	LABEL=Tissue
dermis of feather follicle	LABEL=Tissue
epidermis of feather follicle	LABEL=Tissue
outer epidermal layer of feather follicle	LABEL=Tissue
inner epidermal layer of feather follicle	LABEL=Tissue
superficial fascia	LABEL=Tissue
duct of areolar gland	LABEL=Tissue
endomysium	LABEL=Tissue
smooth muscle endomysium	LABEL=Tissue
cardiac endomysium	LABEL=Tissue
skeletal muscle endomysium	LABEL=Tissue
epimysium	LABEL=Tissue
perimysium	LABEL=Tissue
gizzard smooth muscle	LABEL=Tissue
vibrissa hair bulb	LABEL=Tissue
vibrissa root sheath	LABEL=Tissue
vibrissa inner root sheath	LABEL=Tissue
vibrissa outer root sheath	LABEL=Tissue
arrector pili muscle of vibrissa	LABEL=Tissue
calcaneofibular ligament	LABEL=Tissue
patella cartilage element	LABEL=Tissue
patella pre-cartilage condensation	LABEL=Tissue
infraspinatus tendon	LABEL=Tissue
vinculum tendon of wing	LABEL=Tissue
vinculum of tendon	LABEL=Tissue
buccal fat pad	LABEL=Tissue
tonsil crypt	LABEL=Tissue
tonsil epithelium	LABEL=Tissue
ureteric bud trunk	LABEL=Tissue
thyroid follicle epithelium	LABEL=Tissue
cervix glandular epithelium	LABEL=Tissue
ectocervical epithelium	LABEL=Tissue
endocervical epithelium	LABEL=Tissue
cervical squamo-columnar junction	LABEL=Tissue
mammary fat pad	LABEL=Tissue
femoral fat pad	LABEL=Tissue
penile spine	LABEL=Tissue
subserosal plexus	LABEL=Tissue
retromolar triangle	LABEL=Tissue
respiratory system arterial smooth muscle	LABEL=Tissue
respiratory system venous smooth muscle	LABEL=Tissue
endothelium of peritubular capillary	LABEL=Tissue
muscularis mucosae of duodenum	LABEL=Tissue
muscularis mucosae of rectum	LABEL=Tissue
rectum smooth muscle tissue	LABEL=Tissue
umbilical smooth muscle	LABEL=Tissue
anococcygeus muscle	LABEL=Tissue
bronchial bud	LABEL=Tissue
eyelid submuscular connective tissue	LABEL=Tissue
capillary bed	LABEL=Tissue
1st arch maxillary endoderm	LABEL=Tissue
1st arch mandibular ectoderm	LABEL=Tissue
1st arch mandibular endoderm	LABEL=Tissue
1st arch maxillary-mandibular cleft	LABEL=Tissue
epithalamus mantle layer	LABEL=Tissue
epithalamus ventricular layer	LABEL=Tissue
dorsal bursa	LABEL=Tissue
anterior dorsal bursa	LABEL=Tissue
posterior dorsal bursa	LABEL=Tissue
orthokeratinized epithelium	LABEL=Tissue
parakeratinized epithelium of gingiva	LABEL=Tissue
paradidymis	LABEL=Tissue
paroophoron	LABEL=Tissue
stratum argenteum of choroid	LABEL=Tissue
cecal tonsil	LABEL=Tissue
lung endothelium	LABEL=Tissue
superficial cervical fascia	LABEL=Tissue
cervical fascia	LABEL=Tissue
deep cervical fascia	LABEL=Tissue
prevertebral cervical fascia	LABEL=Tissue
5th arch mesenchyme	LABEL=Tissue
elastica externa of notochord	LABEL=Tissue
spongiose tissue of corpus cavernosum maxillaris	LABEL=Tissue
tonsil germinal center	LABEL=Tissue
appendix lymphoid tissue	LABEL=Tissue
brain endothelium	LABEL=Tissue
colon endothelium	LABEL=Tissue
fascia of Scarpa	LABEL=Tissue
dartos muscle of scrotum	LABEL=Tissue
dartos muscle of labia majora	LABEL=Tissue
base of crypt of Lieberkuhn	LABEL=Tissue
wall of crypt of Lieberkuhn	LABEL=Tissue
base of crypt of Lieberkuhn of large intestine	LABEL=Tissue
wall of crypt of Lieberkuhn of large intestine	LABEL=Tissue
base of crypt of Lieberkuhn of small intestine	LABEL=Tissue
wall of crypt of Lieberkuhn of small intestine	LABEL=Tissue
kidney collecting duct epithelium	LABEL=Tissue
interscapular fat pad	LABEL=Tissue
gustatory epithelium of tongue	LABEL=Tissue
gustatory epithelium of palate	LABEL=Tissue
visceral abdominal adipose tissue	LABEL=Tissue
subcutaneous abdominal adipose tissue	LABEL=Tissue
renal fat pad	LABEL=Tissue
CA3 stratum lucidum	LABEL=Tissue
layer of hippocampal field	LABEL=Tissue
anal membrane ectodermal component	LABEL=Tissue
median lingual swelling epithelium	LABEL=Tissue
carapacial ridge mesenchyme	LABEL=Tissue
carapacial ridge ectoderm	LABEL=Tissue
stomodeal ectoderm	LABEL=Tissue
tendon of quadriceps femoris	LABEL=Tissue
haemolymphatic fluid-testis barrier	LABEL=Tissue
bone condensation	LABEL=Tissue
anterior internodal tract	LABEL=Tissue
posterior internodal tract	LABEL=Tissue
middle internodal tract	LABEL=Tissue
subepicardial layer of epicardium	LABEL=Tissue
epicardial fat	LABEL=Tissue
pericardial fat	LABEL=Tissue
connective tissue of prostate gland	LABEL=Tissue
subepithelial connective tissue of prostatic gland	LABEL=Tissue
extralobar lactiferous duct	LABEL=Tissue
terminal lactiferous duct	LABEL=Tissue
main lactiferous duct	LABEL=Tissue
primary lactiferous duct	LABEL=Tissue
secondary lactiferous duct	LABEL=Tissue
tertiary lactiferous duct	LABEL=Tissue
quarternary lactiferous duct	LABEL=Tissue
falciform fat	LABEL=Tissue
somite boundary epithelium	LABEL=Tissue
perineural vascular plexus	LABEL=Tissue
urethra mesenchymal layer	LABEL=Tissue
blood vessel external elastic membrane	LABEL=Tissue
pancreatic fat pad	LABEL=Tissue
mediastinal fat pad	LABEL=Tissue
axillary fat pad	LABEL=Tissue
epidermis of metapodial pad	LABEL=Tissue
anal canal epithelium	LABEL=Tissue
smooth muscle tissue layer of ejaculatory duct	LABEL=Tissue
inferior tarsal muscle	LABEL=Tissue
heterogeneous tissue	LABEL=Tissue
mixed stratified cuboidal and columnar epithelium	LABEL=Tissue
dense regular elastic tissue	LABEL=Tissue
epithelium of duct of salivary gland	LABEL=Tissue
transitional epithelium of prostatic urethra	LABEL=Tissue
epithelium of male urethra	LABEL=Tissue
smooth muscle layer in fatty layer of subcutaneous tissue	LABEL=Tissue
left lung lobar bronchus epithelium	LABEL=Tissue
right lung lobar bronchus epitheium	LABEL=Tissue
incisor dental pulp	LABEL=Tissue
molar dental pulp	LABEL=Tissue
incisor dental lamina	LABEL=Tissue
molar dental lamina	LABEL=Tissue
dental pulp of median incisor tusk	LABEL=Tissue
root of nail	LABEL=Tissue
compact bone of long bone	LABEL=Tissue
compact bone of diaphysis	LABEL=Tissue
epiphyseal plate of radius	LABEL=Tissue
fibrocollagenous connective tissue	LABEL=Tissue
tendon of palmaris longus	LABEL=Tissue
muscularis mucosa of fundus of urinary bladder	LABEL=Tissue
muscularis mucosae of fundus of stomach	LABEL=Tissue
muscularis mucosae of jejunum	LABEL=Tissue
epithelium of female urethra	LABEL=Tissue
lower foregut region endoderm	LABEL=Tissue
renal fascia	LABEL=Tissue
muscle tissue of terminal part of digestive tract	LABEL=Tissue
hemipenis keratinized epithelium	LABEL=Tissue
periovarian fat pad	LABEL=Tissue
tail fat pad	LABEL=Tissue
type 1 adrenal tissue	LABEL=Tissue
adrenal tissue	LABEL=Tissue
type 2 adrenal tissue	LABEL=Tissue
type 3 adrenal tissue	LABEL=Tissue
type 4 adrenal tissue	LABEL=Tissue
prismatic cartilage	LABEL=Tissue
upper lateral line	LABEL=Tissue
ventral lateral line	LABEL=Tissue
ventral wall of dorsal aorta	LABEL=Tissue
intramuscular adipose tissue	LABEL=Tissue
carotid artery endothelium	LABEL=Tissue
iliac artery endothelium	LABEL=Tissue
tendon of obturator internus	LABEL=Tissue
tongue papilla epithelium	LABEL=Tissue
epithelium of external nose	LABEL=Tissue
epithelium of crypt of Lieberkuhn of small intestine	LABEL=Tissue
epithelium of crypt of Lieberkuhn of large intestine	LABEL=Tissue
basal layer of endometrium	LABEL=Tissue
outer layer of endometrium	LABEL=Tissue
male mammary gland duct	LABEL=Tissue
lung field	LABEL=Tissue
spermatic fascia	LABEL=Tissue
external spermatic fascia	LABEL=Tissue
internal spermatic fascia	LABEL=Tissue
yellow fibrocartilage	LABEL=Tissue
bulbourethral gland epithelium	LABEL=Tissue
stratum lacunosum-moleculare of caudal CA1	LABEL=Tissue
stratum radiatum of caudal CA1	LABEL=Tissue
stratum pyramidale of caudal CA1	LABEL=Tissue
stratum oriens of caudal CA1	LABEL=Tissue
stratum lacunosum-moleculare of caudal CA2	LABEL=Tissue
stratum radiatum of caudal CA2	LABEL=Tissue
stratum pyramidale of caudal CA2	LABEL=Tissue
stratum oriens of caudal CA2	LABEL=Tissue
stratum lacunosum-moleculare of caudal CA3	LABEL=Tissue
stratum radiatum of caudal CA3	LABEL=Tissue
stratum lucidum of caudal CA3	LABEL=Tissue
stratum pyramidale of caudal CA3	LABEL=Tissue
stratum oriens of caudal CA3	LABEL=Tissue
stratum lacunosum-moleculare of rostral CA1	LABEL=Tissue
stratum radiatum of rostral CA1	LABEL=Tissue
stratum pyramidale of rostral CA1	LABEL=Tissue
stratum oriens of rostral CA1	LABEL=Tissue
stratum lacunosum-moleculare of rostral CA2	LABEL=Tissue
stratum radiatum of rostral CA2	LABEL=Tissue
stratum pyramidale of rostral CA2	LABEL=Tissue
stratum oriens of rostral CA2	LABEL=Tissue
stratum lacunosum-moleculare of rostral CA3	LABEL=Tissue
stratum radiatum of rostral CA3	LABEL=Tissue
stratum lucidum of rostral CA3	LABEL=Tissue
stratum pyramidale of rostral CA3	LABEL=Tissue
stratum oriens of rostral CA3	LABEL=Tissue
stratum lacunosum-moleculare of uncal CA1	LABEL=Tissue
stratum radiatum of uncal CA1	LABEL=Tissue
stratum pyramidale of uncal CA1	LABEL=Tissue
stratum oriens of uncal CA1	LABEL=Tissue
stratum lacunosum-moleculare of uncal CA2	LABEL=Tissue
stratum radiatum of uncal CA2	LABEL=Tissue
stratum pyramidale of uncal CA2	LABEL=Tissue
stratum oriens of uncal CA2	LABEL=Tissue
stratum lacunosum-moleculare of uncal CA3	LABEL=Tissue
stratum radiatum of uncal CA3	LABEL=Tissue
stratum lucidum of uncal CA3	LABEL=Tissue
stratum pyramidale of uncal CA3	LABEL=Tissue
stratum oriens of uncal CA3	LABEL=Tissue
mucocartilage tissue	LABEL=Tissue
retroperitoneal embryonic lymph sac	LABEL=Tissue
sacral nerve plexus	LABEL=Tissue
lumbar nerve plexus	LABEL=Tissue
parotid gland myoepithelium	LABEL=Tissue
fascia of tail	LABEL=Tissue
perineal body smooth muscle muscle tissue	LABEL=Tissue
presumptive axochord	LABEL=Tissue
mucoid tissue	LABEL=Tissue
coccygeal nerve plexus	LABEL=Tissue
aortic plexus	LABEL=Tissue
abdominal nerve plexus	LABEL=Tissue
thoracic aortic plexus	LABEL=Tissue
visceral fat	LABEL=Tissue
paracardial fat	LABEL=Tissue
esophagogastric junction muscularis mucosa	LABEL=Tissue
lower esophagus muscularis mucosa	LABEL=Tissue
enthesis	LABEL=Tissue
fibrous enthesis	LABEL=Tissue
fibrocartilage enthesis	LABEL=Tissue
inferior endocardial cushion	LABEL=Tissue
superior endocardial cushion	LABEL=Tissue
respiratory primordium epithelium	LABEL=Tissue
respiratory primordium mesenchyme	LABEL=Tissue
Sertoli cell barrier	LABEL=Tissue
fibroelastic connective tissue	LABEL=Tissue
iliac lymph sac	LABEL=Tissue
accessory lymph sac	LABEL=Tissue
tonsillar pillar	LABEL=Tissue
mole	LABEL=Tissue
anterior axial hypoblast	LABEL=Tissue
axial hypoblast	LABEL=Tissue
intermediate cell mass of mesoderm	LABEL=Tissue
ventral lateral mesoderm	LABEL=Tissue
somite 14	LABEL=Tissue
somite 1	LABEL=Tissue
somite 5	LABEL=Tissue
somite 26	LABEL=Tissue
ventral mesoderm	LABEL=Tissue
macula lagena	LABEL=Tissue
mandibular lateral line	LABEL=Tissue
otic lateral line	LABEL=Tissue
somite 20	LABEL=Tissue
somite 30	LABEL=Tissue
ventral mesenchyme	LABEL=Tissue
anterior macula	LABEL=Tissue
dorsal depressor muscle	LABEL=Tissue
depressor muscle	LABEL=Tissue
gigantocellular part of magnocellular preoptic nucleus	LABEL=Tissue
lateral crista primordium	LABEL=Tissue
lateral line primordium	LABEL=Tissue
lateral semicircular canal primordium	LABEL=Tissue
otic vesicle protrusion	LABEL=Tissue
lower oral valve	LABEL=Tissue
macula neglecta	LABEL=Tissue
posterior macula	LABEL=Tissue
primary olfactory fiber layer	LABEL=Tissue
external yolk syncytial layer	LABEL=Tissue
anal inclinator	LABEL=Tissue
inclinator muscle	LABEL=Tissue
branchiostegal membrane	LABEL=Tissue
dorsal inclinator muscle	LABEL=Tissue
external cellular layer	LABEL=Tissue
granular layer corpus cerebelli	LABEL=Tissue
molecular layer corpus cerebelli	LABEL=Tissue
posterior crista primordium	LABEL=Tissue
posterior semicircular canal primordium	LABEL=Tissue
opercular lateral line	LABEL=Tissue
upper oral valve	LABEL=Tissue
anal depressor	LABEL=Tissue
anterior semicircular canal primordium	LABEL=Tissue
dorsal erector muscle	LABEL=Tissue
erector muscle	LABEL=Tissue
internal cellular layer	LABEL=Tissue
saccus dorsalis	LABEL=Tissue
anal erector	LABEL=Tissue
cerebellar crest	LABEL=Tissue
internal yolk syncytial layer	LABEL=Tissue
epaxial region somite 27	LABEL=Tissue
somite 11	LABEL=Tissue
somite 17	LABEL=Tissue
somite 2	LABEL=Tissue
epaxial region somite 3	LABEL=Tissue
somite 23	LABEL=Tissue
somite 27	LABEL=Tissue
somite 3	LABEL=Tissue
somite 7	LABEL=Tissue
epaxial region somite 11	LABEL=Tissue
epaxial region somite 5	LABEL=Tissue
epaxial region somite 14	LABEL=Tissue
epaxial region somite 17	LABEL=Tissue
epaxial region somite 2	LABEL=Tissue
epaxial region somite 22	LABEL=Tissue
epaxial region somite 25	LABEL=Tissue
epaxial region somite 28	LABEL=Tissue
epaxial region somite 30	LABEL=Tissue
epaxial region somite 6	LABEL=Tissue
epaxial region somite 9	LABEL=Tissue
epaxial region somite 8	LABEL=Tissue
granular layer valvula cerebelli	LABEL=Tissue
hypaxial region somite 11	LABEL=Tissue
hypaxial region somite 14	LABEL=Tissue
hypaxial region somite 17	LABEL=Tissue
hypaxial region somite 2	LABEL=Tissue
hypaxial region somite 22	LABEL=Tissue
hypaxial region somite 25	LABEL=Tissue
hypaxial region somite 28	LABEL=Tissue
hypaxial region somite 30	LABEL=Tissue
hypaxial region somite 6	LABEL=Tissue
hypaxial region somite 9	LABEL=Tissue
mesenchyme dorsal fin	LABEL=Tissue
somite 15	LABEL=Tissue
somite 18	LABEL=Tissue
somite 29	LABEL=Tissue
somite 4	LABEL=Tissue
sclerotome somite 11	LABEL=Tissue
sclerotome somite 14	LABEL=Tissue
sclerotome somite 17	LABEL=Tissue
sclerotome somite 2	LABEL=Tissue
sclerotome somite 22	LABEL=Tissue
somite 22	LABEL=Tissue
sclerotome somite 25	LABEL=Tissue
somite 25	LABEL=Tissue
sclerotome somite 28	LABEL=Tissue
somite 28	LABEL=Tissue
sclerotome somite 30	LABEL=Tissue
sclerotome somite 6	LABEL=Tissue
somite 6	LABEL=Tissue
sclerotome somite 9	LABEL=Tissue
somite 9	LABEL=Tissue
somite 12	LABEL=Tissue
somite 21	LABEL=Tissue
somite 24	LABEL=Tissue
somite 8	LABEL=Tissue
epaxial region somite 1	LABEL=Tissue
epaxial region somite 12	LABEL=Tissue
epaxial region somite 15	LABEL=Tissue
epaxial region somite 18	LABEL=Tissue
epaxial region somite 20	LABEL=Tissue
epaxial region somite 23	LABEL=Tissue
epaxial region somite 26	LABEL=Tissue
epaxial region somite 29	LABEL=Tissue
epaxial region somite 4	LABEL=Tissue
epaxial region somite 7	LABEL=Tissue
floor plate neural rod	LABEL=Tissue
hypaxial region somite 1	LABEL=Tissue
hypaxial region somite 12	LABEL=Tissue
hypaxial region somite 15	LABEL=Tissue
hypaxial region somite 18	LABEL=Tissue
hypaxial region somite 20	LABEL=Tissue
hypaxial region somite 23	LABEL=Tissue
hypaxial region somite 26	LABEL=Tissue
hypaxial region somite 29	LABEL=Tissue
hypaxial region somite 4	LABEL=Tissue
hypaxial region somite 7	LABEL=Tissue
mesenchyme median fin fold	LABEL=Tissue
molecular layer valvula cerebelli	LABEL=Tissue
hypaxial region somite 10	LABEL=Tissue
somite 16	LABEL=Tissue
somite 19	LABEL=Tissue
hypaxial region somite 13	LABEL=Tissue
posterior lateral line primordium	LABEL=Tissue
hypaxial region somite 16	LABEL=Tissue
sclerotome somite 1	LABEL=Tissue
sclerotome somite 12	LABEL=Tissue
sclerotome somite 15	LABEL=Tissue
sclerotome somite 18	LABEL=Tissue
sclerotome somite 20	LABEL=Tissue
hypaxial region somite 19	LABEL=Tissue
sclerotome somite 23	LABEL=Tissue
sclerotome somite 26	LABEL=Tissue
sclerotome somite 29	LABEL=Tissue
sclerotome somite 4	LABEL=Tissue
sclerotome somite 7	LABEL=Tissue
hypaxial region somite 21	LABEL=Tissue
somite 10	LABEL=Tissue
somite 13	LABEL=Tissue
hypaxial region somite 24	LABEL=Tissue
hypaxial region somite 27	LABEL=Tissue
hypaxial region somite 3	LABEL=Tissue
hypaxial region somite 5	LABEL=Tissue
hypaxial region somite 8	LABEL=Tissue
epaxial region somite 10	LABEL=Tissue
lateral wall neural rod	LABEL=Tissue
epaxial region somite 13	LABEL=Tissue
epaxial region somite 16	LABEL=Tissue
epaxial region somite 19	LABEL=Tissue
epaxial region somite 21	LABEL=Tissue
sclerotome somite 10	LABEL=Tissue
sclerotome somite 13	LABEL=Tissue
sclerotome somite 16	LABEL=Tissue
sclerotome somite 19	LABEL=Tissue
epaxial region somite 24	LABEL=Tissue
sclerotome somite 21	LABEL=Tissue
sclerotome somite 24	LABEL=Tissue
sclerotome somite 27	LABEL=Tissue
sclerotome somite 3	LABEL=Tissue
sclerotome somite 5	LABEL=Tissue
sclerotome somite 8	LABEL=Tissue
organizer inducing center	LABEL=Tissue
noninvoluting endocytic marginal cell cluster	LABEL=Tissue
pharyngeal pouches 2-6	LABEL=Tissue
epidermal superficial stratum	LABEL=Tissue
epidermal intermediate stratum	LABEL=Tissue
corpuscles of Stannius	LABEL=Tissue
lateral floor plate	LABEL=Tissue
medial floor plate	LABEL=Tissue
posterior neural keel	LABEL=Tissue
stratum fibrosum et griseum superficiale	LABEL=Tissue
stratum marginale	LABEL=Tissue
stratum opticum	LABEL=Tissue
stratum periventriculare	LABEL=Tissue
alar plate midbrain	LABEL=Tissue
olfactory rosette	LABEL=Tissue
pectoral fin endoskeletal disc	LABEL=Tissue
pharyngeal mesoderm	LABEL=Tissue
anterior lateral line primordium	LABEL=Tissue
notochord posterior region	LABEL=Tissue
anterior swim bladder bud	LABEL=Tissue
branchial mesenchyme	LABEL=Tissue
climbing fiber	LABEL=Tissue
dorsolateral septum	LABEL=Tissue
epidermal placode	LABEL=Tissue
macula communis	LABEL=Tissue
mossy fiber	LABEL=Tissue
otic vesicle ventral protrusion	LABEL=Tissue
parallel fiber	LABEL=Tissue
pillar of the semicircular canal	LABEL=Tissue
Purkinje cell layer corpus cerebelli	LABEL=Tissue
Purkinje cell layer valvula cerebelli	LABEL=Tissue
scale primordium	LABEL=Tissue
rostral blood island	LABEL=Tissue
anterior lateral mesoderm	LABEL=Tissue
bulbus arteriosus outer layer	LABEL=Tissue
endocardial ring	LABEL=Tissue
atrioventricular ring	LABEL=Tissue
central cardiac conduction system	LABEL=Tissue
peripheral cardiac conduction system	LABEL=Tissue
primary posterior lateral line primordium	LABEL=Tissue
secondary posterior lateral line primordium	LABEL=Tissue
middle lateral line primordium	LABEL=Tissue
dorsal axial hypoblast	LABEL=Tissue
intestinal bulb epithelium	LABEL=Tissue
primary dental epithelium	LABEL=Tissue
continuous capillary	LABEL=Tissue
intestinal mucosal muscle	LABEL=Tissue
enteric circular muscle	LABEL=Tissue
pronephric glomerular capsule epithelium	LABEL=Tissue
dorso-rostral cluster	LABEL=Tissue
epiphysial cluster	LABEL=Tissue
anterior presumptive neural plate	LABEL=Tissue
posterior presumptive neural plate	LABEL=Tissue
anterior neural keel	LABEL=Tissue
midbrain neural keel	LABEL=Tissue
forebrain neural keel	LABEL=Tissue
spinal cord neural keel	LABEL=Tissue
hindbrain neural keel	LABEL=Tissue
posterior neural rod	LABEL=Tissue
anterior neural rod	LABEL=Tissue
midbrain neural rod	LABEL=Tissue
forebrain neural rod	LABEL=Tissue
spinal cord neural rod	LABEL=Tissue
hindbrain neural rod	LABEL=Tissue
forebrain neural tube	LABEL=Tissue
spinal cord neural tube	LABEL=Tissue
hindbrain neural tube	LABEL=Tissue
pillar of the anterior semicircular canal	LABEL=Tissue
pillar of the lateral semicircular canal	LABEL=Tissue
neurogenic field	LABEL=Tissue
dorsolateral field	LABEL=Tissue
epibranchial field	LABEL=Tissue
olfactory field	LABEL=Tissue
alary cartilage	LABEL=Tissue
basimandibulare	LABEL=Tissue
cartilago ectochoanalis	LABEL=Tissue
cartilago infranarina	LABEL=Tissue
cartilago retronarina	LABEL=Tissue
fenestra dorsalis nasi	LABEL=Tissue
nasal opening	LABEL=Tissue
fenestra endochoanalis	LABEL=Tissue
fenestra endonarina communis	LABEL=Tissue
fenestra lateralis nasi	LABEL=Tissue
fenestra nasobasalis	LABEL=Tissue
fenestra nasolateralis	LABEL=Tissue
fenestra precerebralis	LABEL=Tissue
fenestra prechoanalis	LABEL=Tissue
foramen orbitonasale laterale	LABEL=Tissue
foramen orbitonasale mediale	LABEL=Tissue
inferior prenasal cartilage	LABEL=Tissue
medial inferior prenasal cartilage	LABEL=Tissue
medial orbitonasal foramen	LABEL=Tissue
oblique cartilage	LABEL=Tissue
olfactory foramen	LABEL=Tissue
paranasal commissure	LABEL=Tissue
paries nasi	LABEL=Tissue
pars amphibiorum	LABEL=Tissue
pars basilaris	LABEL=Tissue
planum antorbitale	LABEL=Tissue
planum conchale	LABEL=Tissue
planum internasale	LABEL=Tissue
specialized connective tissue	LABEL=Tissue
superior prenasal cartilage	LABEL=Tissue
pars acromialis	LABEL=Tissue
pars glenoidalis of scapula	LABEL=Tissue
equatorial belt	LABEL=Tissue
inner fin tissue	LABEL=Tissue
outer fin tissue	LABEL=Tissue
ovisac	LABEL=Tissue
hyoid arch neural crest	LABEL=Tissue
cloacal papilla	LABEL=Tissue
ramus muscularis of glossopharyngeus nerve	LABEL=Tissue
ramule palatonasalis	LABEL=Tissue
descending branch of the vagus nerve	LABEL=Tissue
ramus muscularis of vagus nerve	LABEL=Tissue
anterior prenasal cartilage	LABEL=Tissue
late distal segment	LABEL=Tissue
mineralized extracellular matrix	LABEL=Tissue
integumentary papilla	LABEL=Tissue
oropharyngeal papilla	LABEL=Tissue
vacuolated notochordal tissue	LABEL=Tissue
avascular GAG-rich matrix	LABEL=Tissue
non-mineralized chondroid tissue	LABEL=Tissue
chondroid tissue	LABEL=Tissue
secondary cartilage tissue	LABEL=Tissue
cosmine	LABEL=Tissue
mineralized cartilage tissue	LABEL=Tissue
orthodentine	LABEL=Tissue
osteodentine	LABEL=Tissue
ganoine	LABEL=Tissue
limiting layer of elasmoid scale	LABEL=Tissue
vasodentine	LABEL=Tissue
elasmodine	LABEL=Tissue
non-mineralized hyaline cartilage tissue	LABEL=Tissue
mineralized hyaline cartilage tissue	LABEL=Tissue
mineralized bone tissue	LABEL=Tissue
cellular bone tissue	LABEL=Tissue
acellular bone tissue	LABEL=Tissue
non-mineralized avascular GAG-rich matrix	LABEL=Tissue
mineralized avascular GAG-rich matrix	LABEL=Tissue
odontode tissue	LABEL=Tissue
musculotendinous bundle	LABEL=Tissue
Sharpey's fiber	LABEL=Tissue
acrodin	LABEL=Tissue
forelimb bud mesenchyme	LABEL=Tissue
hindlimb bud mesenchyme	LABEL=Tissue
pectoral fin bud mesenchyme	LABEL=Tissue
pelvic fin bud mesenchyme	LABEL=Tissue
forelimb wing bud mesenchyme	LABEL=Tissue
ventral furrow	LABEL=Tissue
epithelial furrow	LABEL=Tissue
cephalic furrow	LABEL=Tissue
mesoderm anlage	LABEL=Tissue
dorsal ectoderm anlage	LABEL=Tissue
trunk mesoderm	LABEL=Tissue
trunk mesoderm anlage	LABEL=Tissue
visual anlage	LABEL=Tissue
proneural cluster	LABEL=Tissue
labial disc	LABEL=Tissue
clypeo-labral disc	LABEL=Tissue
eye-antennal disc	LABEL=Tissue
antennal disc	LABEL=Tissue
dorsal thoracic disc	LABEL=Tissue
wing disc	LABEL=Tissue
haltere disc	LABEL=Tissue
ventral thoracic disc	LABEL=Tissue
prothoracic leg disc	LABEL=Tissue
genital disc	LABEL=Tissue
male genital disc	LABEL=Tissue
female genital disc	LABEL=Tissue
adult clypeo-labral anlage	LABEL=Tissue
presumptive arista	LABEL=Tissue
mesothoracic tergum primordium	LABEL=Tissue
presumptive prothoracic metatarsus	LABEL=Tissue
ectoderm anlage	LABEL=Tissue
clypeo-labral anlage	LABEL=Tissue
abdominal histoblast anlage	LABEL=Tissue